
 01-NOV-1989

 CPMNOV01.LST is a list of CP/M public domain files as of
 the above date.  The listing is sorted alphabetically by
 filename within each category.  Each filename has a short
 one-line description.	This file will be replaced periodically
 as new files are added.

 See the file GENIECPM.INF, available on this system, for
 further information about the National CP/M RoundTable on
 GEnie.

 --Keith Petersen, W8SDZ

 GEnie CP/M RoundTable Software Libraries.


    Library  1. ASM Utilities/Program Debug Tools

18E-SRC.LBR	Source for 18e debug monitor
18E.LBR 	Debugger offers HD64180 support
ARRAY10B.LBR	Manipulate a two dimensional array
ARRAYLIB.LBR	Subroutines for array accessing
ASCIIMP2.LBR	Print ASCII table on screen or LPT:
ASMHELP.LBR	Assembly language primer
ASMSUBS.LBR	Handy submit files - ASM,M80,L80,MAC
BDOSFUNC.DQC	A BDOS Function Summary
BIGLIB.LBR	Subroutines for string manipulation
BUFFERS.LBR	Assembly language buffering routines
CALL-CPM.LBR	Experiment with CP/M function calls
CCPCHAIN.LBR	Chains assembly language programs
CHKIF.LBR	Check for balanced conditionals
CLNRES.LBR	Cleans disassembled source files
CMP21.LBR	Unix-style binary file comparison
CONVRS12.LBR	Converts ASCII, Binary, Decimal, HEX
CROWECPM.LBR	CROWE Z80 assembler
DDTF5.LBR	Find string add-on for DDT, SID
DDTTOOLS.AQM	Many useful enhancements for DDT
DDTZ27.ARK	Z80/V20/8080/64180 debugger
DECODER.LBR	Decodes relocatable modules
DIRF.AQM	Routines allow listing of directory
DIRF.MQC	Routine for listing directory (M80)
DISKDEF.ARK	Define the disk drives to CP/M BIOS
DISPMEN.LBR	Display menus in two columns
DLNKLOC2.LBR	Disk based linker and loader
DUMPH.LBR	Dumps memory to the screen
EASYBDOS.LBR	3-part tutorial - Understanding BDOS
EM220.LBR	Aid in teaching 8080 assembly lang.
ENTAB16.LBR	Replaces spaces with tabs in source
EXTONE1.LBR	NOISE subroutine for Executive I
FCB10.LBR	Shows FCB command tail formulation
FORM7.LBR	Formats assembler language source
FRESET.AZM	Fast reset of CP/M drives
GEN180.LBR	Adds HD64180 instructions to M80
H80.LZB 	Macros for HD64180 unique opcodes
HLOAD.LBR	Loads a HEX file into memory
ID2ID.LBR	Renames identifiers in source code
INSIDCPM.LBR	Source used in Cortesi's INSIDE CP/M
JMON100.LBR	Debugger/Monitor for banked memory
LASM-TDL.LBR	TDL MNEMONIC Z80 ASSEMBLER
LASM.LBR	A linking CP/M 8080 assembler
LB-TSTP1.LBR	Install date/time in source code
LC22.LBR	Converts ASM files to lower case
LINK80.DZC	Help for using LINK-80
M22.LBR 	Displays memory in HEX and ASCII
M80-L80.DZC	Answer to macro assembler questions
M80-L80.LBR	Help for using M80/L80
M80DATE.LBR	Current Date/Time in M80 lists
M80STR11.LBR	Structured programming for M80
MAC.FQX 	Lower case in PRN files with MAC asm
MACLIBS.LBR	Macros for use with MAC/RMAC
MACROZ.MZC	Macros for use with M80
MAKE-DS.LBR	Unix Make, CP/M DateStamper version
MATH24.LBR	Math subroutines and macros for Z80
MEYERTUT.ARK	CP/M 8080 assembly language tutorial
MIMIC.LBR	Mimics keystrokes to screen
MLOAD24.BUG	Fix for MLOAD overlay CCP
MLOAD25.LBR	Improved LOAD.COM replacement
MONITOR.LBR	Monitor for programming development
MOVHEX.LBR	Changes load location of HEX file
MPBLIB.LBR	Subroutines for binary arithmetic
MPDLIB.LBR	Subroutines for decimal arithmetic
NEAT7.LBR	Formats assembler language source
OPTYPE.LBR	Lists Z80/TDL mnemonics
PAGE0.LBR	Memory dump of page 0 in hex
PALASM.LBR	Programmable Array Logic Assembler
PATDDTZ.SZB	Patch DDTZ to use CP/M DDT commands
PDLN10.LBR	Linker Loader, Creates COM from REL
PEEK22.LBR	Trace system level disk I/O calls
PMAKE2.LBR	A 'make file' utility for CP/M-80
PMLINKER.ARK	Linker for Z80MR assembler
PRETTY23.LBR	Reformat assembler language source
PRLMOV.AQM	PRL file relocater to under CCP
PRLOD.AQM	PRL file relocater
PROLNK15.LBR	Advanced linkage editor-REL/HEX file
PROTCCP.LBR	Protect CCP from being overwritten
PRTVAL.ZZ0	Macro prints assembly-time values
Q.LBR		HEX and translated dump of memory
RELOC23.LBR	Generates self-relocating programs
RELOCATE.TZT	Writing assembler relocatable code
RLIB12.LBR	REL file library manager
RMLOAD11.LBR	A .REL file merge loader
SDT.LBR 	Enhancement patch for CP/M 2.2's DDT
SGEN2.LBR	SYSGEN CP/M for 3 or more tracks
SHOFNC10.LBR	Trace BDOS calls in executed program
SID2TTY.LBR	SID/DDT console redirection patch
SLOAD.LBR	Enhanced replacement for LOAD.COM
SMMACLNK.ARK	Small-Mac macro assembler and linker
SORTSYM.LBR	Sorted symbol file for M80/L80
SPASM201.LBR	Single pass assembler, 8080 mnemonic
STRIP11.LBR	Strip comments from assembly source
STRLIB.LBR	Subroutines for string manipulation
SYMX23.ARK	Expanded symbol table for M80 assemb
TDL-TOOL.LBR	TDL assembler/debugger/disassembler
TMSTP1.ZZX	Save date in ASCII source files
TOHEX.LBR	Converts REL file to HEX
TOOLS.LBR	Collection of CP/M utilities
UCASM.LBR	Assembler for 80xx micro-controllers
UNLOAD23.LBR	Convert a .COM file to a .HEX file
VRSLIB10.LBR	Keep track of versions of programs
WADE.LBR	Interactive symbolic Z80 debugger
WADESRC.LBR	Source code for WADE Z80 debugger
XIZI-3.LBR	Intel 8080 <--> Zilog Z80 translator
XLATE6.LBR	8080 to Zilog Z80 source translator
XLT104.LBR	Translate 8080 to Zilog Z80 source
XLT8-80.LBR	Zilog Z80 to 8080 translator ver. 3
XLT86.LBR	8080 to 8086 source code translator
XLTZ804.LBR	8080 to Zilog Z80 source translator
XREF27.LBR	Cross-reference for assembler source
XREF36.LBR	Cross reference for assembler lists
XRFASM27.LBR	Cross reference assembler source
XZRL10.LBR	Gives information for REL/ZRL files
Z1.ARK		Fast Z80 assembler, Z80MR compatible
Z280-ASM.LBR	M80/Z80ASM macros to assemble Z280
Z80ASM24.LBR	Assembler for Zilog OP codes
Z80MR-A.LBR	Enhanced 8080/Z80 macro assembler
Z80MR.UZD	Corrections to Z80MR documentation
Z80TABLE.DQC	MAC/Z80.LBR-Zilog mnemonics crossref
Z8E14.LBR	Screen-oriented Z80 debugger
Z8E35.ARK	Interactive debugging tool for Z80
Z8E35.TZT	Patch history from Z8e source code
Z8E35I.ARK	Z80 Debugger with 64180 op-codes
ZDEBUG17.LBR	Z80 machine language debugger
ZDP.LBR 	Relocatable Z80 debug/trace/edit
ZDT20.LBR	Debugger using TDL Z-80 Mnemonics
ZLINK14.LBR	Linkage editor for ZMAC
ZLOAD.LBR	A program loader with offset option
ZM3P.LBR	Assembler for Zilog source
ZMAC17.LBR	Assembler for Zilog Mnemonics
ZMACLINK.LBR	Z80 macro assem/linker/relocatable
ZMNEMONS.DQC	ZILOG/TDL Z80 mnemonics cross-ref.
ZMRSYM.LBR	Z80MR SYM files for debugging
ZSM.LBR 	Z80 assembler, linker, and patcher
ZSM23.LBR	Z80 macro assembler, linker, patcher

    Library  2. BASIC

555-IC.BQS	Find values for 555 timer-oscillator
567-IC.BQS	Finds values for 567 tone decoder
AIRMILES.BZS	Calculate city-to-city airmiles
ASTRMENU.LBR	Astronomy calculations in MBASIC
ASTRNMY2.BZS	Astronomy Related programs
ASTROLOG.LBR	Horoscope planet position calculator
ATTEN.BZS	T, Pi, MinLoss Attenuator Design
AUDIOLAB.BZS	Calculates values used in audio
B-COMPIL.LBR	Public Domain BASIC compiler
BALISTIC.BZS	Davis exterior ballistics program
BAS-REL1.LBR	Machine language subrtns for BASCOM
BASCMNOT.LBR	Notes on the use of BASCOM
BASECONV.LBR	Convert numbers to other bases
BASIC5.LBR	Processor Technology 5k Basic
BASSTAT.CZM	BASIC File-Type Identifier
BASUTIL.LBR	Comprehensive BASIC utility routines
BE-DEMOS.LIB	Series of BASIC-E demo files
BEARING.BZS	A heading/distance program
BESTBEAM.BZS	Beam Headings for Ham DXing
BILLING.LBR	MBASIC billing programs
CODECRAK.LBR	Decodes DISARM data file.
CVRISK.LBR	A cardiovascular risk program
DATER.LBR	Stores current date in low memory
DEPREC.BZS	calculate Tax Depreciation
DXCC10.ARK	Ham Radio DXCC Tracking program
EBASIC.LBR	Two-step BASIC compiler/interpreter
EGBAS.LBR	Sample programs for MBASIC
EXTEND.LBR	MBasic assembly Language Extensions
EZFILE.LBR	Create and add to sequential files
FND1-800.LBR	Find words in a seven digit phone #
FOURIER.BZS	Fourier Series Signal Analysis
FUNKEY.BQS	Wyse/TeleV. term. function key set
GCDLCM.BQS	Calculates greatest common divisor
GEOSAT.BZS	AZ/EL for TVRO Satellites
GERMAN.BZS	Test vocabulary skills in German
GWFLD.BZS	Ground Wave Propagation In MBASIC
HAMHELP.BZS	Radio Related Formula
HFPROP.BZS	HF propagation program
HURRICPM.BZS	Track hurricanes!!
IC-TIMER.BQS	Calculate IC timer chip R/C values
INDUCT20.BZS	Inductance calculations in MBasic
INTERMOD.BZS	Calculate radio InterMod products
INVEST.LBR	Investment calculations in MBASIC
KEYWRDFX.BQS	Adds space after keywords in MBASIC
LABEL24.BZS	Prints 7 line 4 x 1 7/16 in. labels
LATIN.BZS	Test vocabulary skills in Latin
LEPREP.BQS	Punches readable characters on tape
LOAN2.BZS	Loan calculation program
LOG10K.BZS	Elkin's Log 10000! Benchmark
MANDELBR.LBR	Draw geometrical patterns in MBASIC
MATH.ARK	Scientific math routines for BASIC
MBAS/XR.BQS	Lists cross-ref of variables in pgm
MBAS521.MOD	MBASIC 5.21 DELete key mod
MBASTIP1.TXT	MBASIC cursor addressing tip
MBEXTEND.LBR	MBASIC assembly language extensions
MBPRE-12.LBR	Allows writing MBASIC without line #
MOCST3.LBR	Nice freeware amortization program.
MONOBAND.BZS	HF Beam Antenna Design
MORTGAG.LBR	Interest/mortgage programs in MBASIC
MORTGAGE.BQS	An mortgage analysis program
MXPLOT.BZS	an Epson Plotting program
NBASIC2A.LBR	Structured preprocessor for MBASIC
NETWORK.LBR	RF filter/network/trans. line design
OHMSLAW.BZS	Calculates values based on Ohm's law
PBS.LBR 	Pre-processor for BASIC programs
PKACPM.BZS	Henderson-Hasselbach Drug Calcs.
PSALMS.LBR	Tests ability to memorize Psalms
RACE2.LBR	Calculate car race track times
RESUME.LBR	Mbasic programs help you make resume
RS2MS.BQS	TRS80 Basic to Microsoft Basic conv.
SATCOM.LBR	Positions home earth stations
STACKALC.BZS	RPN Calculator in MTBasic
TINIDISK.LBR	Sherry Brothers Tiny Basic ver 3.1
TTL-SCRL.BAS	Scrolls banner across screen
TVDIR.BZS	TV Channel ===> Frequency Info
TXT2HLP.LBR	Create help files for BASIC
UNIGRID2.BZS	update to N6NB's gridlocator prog.
UNPRO.LBR	UNprotect MBASIC pgms saved with ,P
UNSQUISH.LBR	Convert MBASIC 4.x to 5.x programs
VHFPROP.BZS	VHF/UHF propagation program
WX52CPM.BZS	Weather Forecasts and Data
XFERTIM2.BQS	Shows transfer time of files
XFORMER.BZS	Transformer Design Aid
XREF20.BZS	Cross reference utility for MBasic
ZBASDEMO.LBR	Free demo of ZBASIC from ZEDCOR, Inc

    Library  3. C Language

ACRL.LBR	Assembler for use with BDS-C
ARCSRC.ARC	ARC 5.21 (with squashing) for Unix
AZ-CROOT.LBR	Add wild cards and pipes to Aztec-C
AZPIPE10.LBR	Pipes for Aztec C, v. 1.06
BDSLIB.ARK	Standard C Library for BDS-C 1.5
BOOZ102.ARC	C language ZOO extract for Unix
C-BEAUT.LBR	A 'C' source statement beautifier
CB14.LBR	C source reformat utility
CCHECK.LBR	Checks syntax of C source statements
CELAUTMA.C	Cellular automata by Art Yerkes
COMND004.ARK	TOPS20-style command parsing/Aztec-C
COMPRES4.ARC	Unix LZW 'compress' v4.0 - 'C' src
CPMUTL7.LBR	Read/write CP/M floppy on VAX-780
CURLY.ARK	Check for unmatched curly braces
FLOAT.LBR	Floating point routines for C
FP-MATH.LBR	BDS-C floating point math package
HEX80GEN.LBR	C functions to generate 'hex' files
L2-225.ARK	Improved L2 linker for BDS-C compile
MFILE.LBR	Use many files concurrently in 'C'
QUOTE.ARK	Prints quotes from indexed file
SCI-12.ARK	Small-C Interpreter - version 1.2
SE101.ARK	Simple EDIT text editor w/C source
SMC203.ARK	Small-C Compiler version 2.03
SMC211LI.LBR	Small-C compiler ver. 2.11 libraries
SMC211OB.LBR	Small-C compiler ver. 2.11
SMC211SR.LBR	Source code for the Small-C compiler
SMC21LIB.LBR	Small-C Compiler ver. 2.1 part #3
SMC21OBJ.LBR	Small-C Compiler ver. 2.1 part #2
SMC21SRC.LBR	Small-C Compiler ver. 2.1 part #1
SNOBOL.LBR	SNOBOL4 like pattern matcher in C
TELED14.LBR	Modem terminal/file transfer - BDS-C
UNCR231D.ARC	Portable C-language UNCRUNCH
UNSIT15S.ARC	Macintosh StuffIt extract for Unix
UZI-UTIL.ARK	File management utilities for UZI
UZI.ARK 	Unix 7th Edition Kernel for Z80 CP/M
XC1E.LBR	'C' cross-reference utility
XINU.ARK	Unix-like operating system in 'C'
XMODEM34.ARC	XMODEM/YMODEM for Unix BSD 4.2/4.3
XREFC26.LBR	Cross reference of C programs
YAM428.ARK	Forsberg XMODEM/YMODEM pgm in BDS-C
ZMODEM16.ARC	X/Y/ZMODEM for Unix and VAX/VMS

    Library  4. CP/M-Plus

ABOVE10.ARK	Desktop utility for CP/M-Plus
ARK04P.ARK	Create ARK files with CP/M Plus
BANKRSX2.LBR	Examine memory not in TPA bank 1
BANKSWAP.LBR	Provides access to alternate memory
BIOS2RSX.LBR	CP/M 2.2 BIOS support for CP/M-Plus
BIOS3.AZM	BIOS for CP/M-Plus and DJ2D
CCP105+.ARK	A CCP replacement for CP/M Plus
CHN31.LBR	Chain CP/M+ multiple COM files
CPM+ADD4.LBR	Displays useful addresses for CP/M 3
CPM22EM.AZM	Emulate CP/M 2.2 for CP/M 3 systems
CPM3DATE.IZS	CP/M Plus date insert for SETD01
CPM3LIB.LBR	CP/M-Plus subroutine REL library
CPM3SCB.LBR	Describes CP/M 3.1 Sys Control Block
CPM3WIN.ARK	Use Micronics HD W/ Magnolia CP/M+
CPMMAKE.ARK	CP/M-Plus version of Unix MAKE util.
CPMORE30.ARK	Integrated set of CP/M 3.0 utilities
DATE+.LBR	CP/M+ DATE.COM replacement
DATE+2.LBR	CP/M Plus DATE replacement
DATE.PQS	Turbo version of CP/M+ DATE utility
DIRDATE.SUB	CP/M+ DIR patch shows date in DD/MM
DP-DUP.LBR	Spool print requests in CP/M+
DP-UPD.LBR	Print spooler for CP/M Plus
DUONCPM+.LBR	Disk/User syntax with CP/M+
HIST+.LBR	A history command for CP/M+
HP+.LBR 	A calculator for programmers
LBRDSK31.LBR	Treat library as drive for CP/M+
MFBIOS.ARK	CP/M+ BIOS for Multi-Format program
MFORMAT.LBR	Formats RAM disk on cold boot
MFPGM.ARK	CP/M+ Multi-Format diskette handler
MOUSE.ARK	Logitech mouse driver RSX for CP/M+
NEUTEXEC.LBR	Technical character generator
QS-CPM3.ARK	Set/reset file attributes in CP/M 3
RSXDEMO.DQC	Demonstrates how to use RSX's
RSXDEMO.LBR	Demo for CP/M Plus use of RSX
RSXDIR.LBR	List names of current RSX's (CP/M+)
RSXMAP.LBR	Display dynamic memory in CP/M Plus
SCAN.LBR	CP/M-Plus disk bad sector scan util.
SCRMBL21.LBR	Encodes a CP/M file
SFILE+10.LBR	CP/M-Plus find file drive/user
SIDRSX11.LBR	RSX allows hex/ascii search with SID
SYNONYM+.LBR	Create synonyms for CP/M commands
TIMEBSX.LBR	Time routines for banked XBIOS
U3-V11.LBR	CP/M+ utility recovers erased files
UN33.ARK	UNERASE for CP/M Plus
VERIFY.LBR	Find bad sectors for CP/M Plus
WRITECCP.LBR	Writes CCP to system tracks

    Library  5. CP/M-86

8080.LBR	8080 emulator for CP/M-86
BISHOW86.LBR	CP/M86 bi-directional ASCII viewer
BYE86B.AQ6	Remote console RCP/M for CP/M-86
CCPR8612.LBR	Better CCP for CP/M-86
DELBR11.CMD	LBR file extractor for CP/M-86
DU.CMD		Disk utility for CP/M-86
LU86-2.LBR	Library Utility for CP/M-86
MBOOT86.A86	MODEM bootstrap program - CP/M-86
MDM9IBM1.AQ6	XMODEM/MODEM for CP/M-86 on IBM-PC
MDM9IBM1.FIX	A bug fix for MDM9IBM1.AQ6
MDMRB5.CMD	XMODEM for the DEC Rainbow 100
MODEM840.LBR	MDM740 (MODEM7) for CP/M-86
NSWP207.CMD	NSWEEP ver 2.07 for CP/M-86
NUSQ110.DOC	Instructions for NUSQ UnSQueezer
NUSQ111.CMD	Fast assembly language UnSQueezer
SWV20.LBR	CP/M 2.2 emulator for CP/M-86 mach.
XM6104.AQ6	XMODEM for CP/M-86
XMGEN1.PAT	Modem hardware overlay for XM6104

    Library  6. Cross ASM/DISASM/Simulators

6502DASM.LBR	6502 disassembler for CP/M-80
6502SIM.LBR	Runs 6502 code on 8080/Z80 system
68KXASM.LBR	68000 cross-assembler for CP/M-80
COM.68K 	8080 (CP/M 2.2) emulator for CP/M-68
COM.LBR 	Source code for COM.68K
COM1BP.PQT	Source code patch for COM.68K
DASMTDL.LBR	Disassembler for TDL or Z80 mnemonic
DCOM8048.LBR	A disassembler for 8048, 8049, 8041
DISA-REL.LBR	REL file disassembler
DISREL.LBR	Disassembler for REL files
DZ-NOV86.LBR	DazzleStar vid-oriented disassembler
MSA15.LBR	Simple, fast 8080 disassembler.
REVAS25.LBR	PD version of REVerse ASsembler
Z80DIS21.LBR	8080/Z80 intelligent disassembler
Z80DIS22.LBR	Disassembler for Z80 code
ZDASM15.LBR	Z80 (Zilog/TDL) disassembler
ZDINS21.LBR	Install files for Z80DIS21

    Library  7. Database/Information Processing

AF5.LBR 	Mailing list database manager
ALMANAC.LBR	Computes position of sun/moon/planet
ANIMATE.LBR	Animate a character string for dBase
ANIMATE2.CQD	Problem with dBASE ANIMATE.CMD
AREA17.LBR	Find location by areacode or city
AREACODE.LBR	Area Code Database for JetFind
ASTRONMY.LBR	Astronomy Programs in BASIC
BANKING.LBR	Small business checking system
BIBLIO.LBR	Bibliographic search program
BIZMII-1.ARK	Business Master II - Documentation
BIZMII-2.ARK	Business Master II - Startup
BIZMII-3.ARK	Business Master II - Sample files
BIZMII-4.ARK	Business Master II - Orders
BIZMII-5.ARK	Business Master II - General Ledger
BMBUG.ARK	Business Master II - Info and fixes
CALL11.LBR	Manage phone no. file and make call
CAP2SDF.LBR	Convert GEnie directory to SDF file
CB80MAIL.DZC	Docs for CB80MAIL mailing list mgr.
CB80MAIL.LBR	Mailing list manager with ISAM
CHECKSDB.LBR	dBASEII deluxe checkbook maintainer
CHEF-5.LBR	A recipe data base program
CHEF-FIX.LBR	Fix to CHEF, the recipe program
CHURCH.ARK	dBASEII Church Member database
CMDGEN.LBR	Generate dBase command files
COINCOL.LBR	Database program for coin collection
CPMTAX.ARK	1988 tax preparation 1040/1040A
CREATOR.LBR	A database and report generator
DATA206.LBR	MBasic database management system
DATAFLO2.LBR	dBASEII business package update
DATAFLOW.LBR	dBASEII ledger/stock/order/invoice
DB-CHECK.LBR	A dBASEII checkbook system
DB-GEN.LBR	Automatic Menu generator for dBaseII
DB-SQZ5L.LBR	Compresses dBASEII command files
DB110.LBR	Modula- Database -- new version
DB2SHL30.ARK	Multi-purpose shell for dBASEII
DBAR-12.LBR	dBASE and GRAPH bargraph maker
DBAS2FIL.DOC	Documents structure of dBASEII files
DBASEDIR.ARK	Reads directory into dBASEII files
DBASEPOL.LBR	dBASE Purchase Order system
DBASETIP.LBR	Osborne 1 easy screen format w/dBASE
DBASM.AQM	dBASEII callable ASM rtns for DIR
DBCLINIC.LBR	dBASEII file maintenance utility
DBCLOC11.LBR	Gets date for dBII from DateStamper
DBDECODE.LBR	Decrypts compiled dBASE II CMD files
DBEZMENU.TQT	Easier creation of dBASEII menus
DBHELP2.LBR	dBASEII on-line HELP command
DBJULIAN.LBR	Set current date on dBASEII menu top
DBLIBRAY.LBR	Database for articles and books
DBLIST11.LBR	Produces cross reference for dBASE
DBMUSIC.LBR	Dbase II Music Management system
DBPRINT.LBR	Control Gemini 10X ptr from dBASEII
DBSEX.LBR	Secures dBASEII command files
DBSHOP30.LBR	dBASEII grocery shopping system
DBSQUASH.LBR	Compacts dBASEII command files
DBSRC102.LBR	Decodes dBase II command files
DBUNIQ23.LBR	Purges DBASEII file of duplicates
DIMS103.ARK	File management utility in MBasic
DIRECTRY.BQS	Maintain Name and Address data base
DIRFILE4.LBR	dBASE directory utility.
DMASTER.LBR	dBase file maintenance program
DOZ.ARK 	dBASEII menu command file; good
ENCODE6.LBR	Pseudo compiler for dBASEII
FAMILY.LBR	Church Membership Management system
FILCRD46.LBR	4-by-6 file card database
FILER.DTE	Perfect Filer patch for date problem
FMLYTRE2.LBR	A family tree database program
FT-CPM.ARK	Family Ties Genealogy program
GENE10.LBR	Genealogy database for Coleco Adam
GENE23.DZT	Damaged file from GENE23.LBR
GENE23.LBR	Genealogy program
GENEOLGY.BUG	Small bug fix for GENEOLGY.LBR
GENEOLGY.LBR	dBASEII Family Genealogy database
GENSTAT.LBR	A general statistics program
HOMEINVN.ARK	Home inventory for insurance claims
HOMEINVT.LBR	dBASEII home inventory system
HOMELOAN.ARK	Calculate aspects of any type loan
INVSTMNT.LBR	Calculate stock purchase commissions
KEEPTRAK.LBR	Club Membership Data Base System
KP-DB22.LBR	A multiple mailing list database pgm
LEDGERS.LBR	dBASE menu-driven general ledger sys
LETTER.LBR	Send out form letters with dBASE
LIST-LOG.LBR	Manipulate list of records
M2DB103.ARK	Modula-2 name/address filing program
MAIL20.ARK	Comprehensive mailing list database
MAIL65L.ARK	dBASE system manages mailing lists
NAVPROG7.LBR	Prepares a flight log
NEWBAS11.AZM	User Modifications to dBase II
ORBIT23.ARK	Ham Radio satellite orbit simulator
PAMS10.LBR	Self contained database of BBS lists
PCFILE.ARK	Osborne/C-128 Database
PF2ASC12.ARK	Perfect Filer conversion utility
PFMANAG.ARK	Portfolio Management Program dBaseII
PHONEDAT.LBR	Keep track of RCP/M and BBS systems
PI-EVAL.LBR	Translate injury into dollar value
RECIPE.LBR	A recipe file program
REMSCR.AQM	Converts dBase to use on 2 computers
SCHEDULE.ARK	A personal schedule handler
SCRIVNER.LBR	Outstanding data/text manipulator
SDB.LBR 	Simple Data Base for CP/M-68K
SEARCH22.LBR	Search text files for a Keyword
SEARCHA.LBR	Search ASCII file for pattern match
STATS.LBR	Generate statistics reports
SUPRCKBK.LBR	dBASEII Super Checkbook 26 routines
TDAS.ARK	Teacher/Doctor dBASEII account syst.
TITLES2.LBR	Create an index of first lines
TOLOG.LBR	Flexible database utility for dBase
TOOLSLIB.LBR	Software tools for dBASEII
TRACK2.LBR	Tracks names, phone numbers, address
TRIG7DB2.LBR	Trigonometry routines for dBASEII
TTGEN10C.LBR	Format family database
UNIQUE24.ARK	Purges duplicate records for dBASEII
VIDEOSTO.ARK	Video rental store management system
VIDLOG20.LBR	Logging home videotapes - dBASEII

    Library  8. Desk Accessories/Calculators

@.LBR		An online expression evaluator
ABOVE12.LBR	Above, resident utility; H89's only
AIM30.LBR	Tracks and advises stock investments
ANNUITY.ARK	Calc. missing variable in annuities
AXCAL87.LBR	Monthly appointment calendar
BASE.LBR	Number conversion program
BIGCAL2.BQS	Extended precision calculator
CAL-13.LBR	Prints calendar for month or year
CAL.LBR 	Accurate calendars for 32767 years
CAL33.ARK	CALender/notepad program
CALC32.LBR	Calculator does 32 bit arithmetic
CALENDAR.LBR	Appointment calendar
CALNDR.LBR	Compute # of days between any 2 days
CHX8010A.LBR	A Check Register Program - part A
CHX8010B.LBR	A Check Register Program - part B
CLNDR.LBR	Twelve month calendar for any year
DESCALC.LBR	Desk calculator uses RPN
EAC.LBR 	Calculator for large numbers
EXWINDOW.LBR	Osborne Exec. two windows on screen
FINPAK-C.LBR	A multi-function financial package
HANDY+10.LBR	dBaseII version of HANDY system
HANDY21S.LBR	Source for Personal Time Mgm't Sys
HANDY21X.LBR	Personal Time Management System
HIPPO11C.LBR	Security investment report/organize
HP.LBR		A calculator for programmers
HP12.LBR	HP-like Programmer's Calculator
HP45-208.LBR	HP45-like RPN scientific calculator
HPC10.LBR	HP-like Floating-Point Calculator
HPCALC12.LBR	Full function HP calculator
IRA.LBR 	An IRA Calculator
LBB22.LBR	Adrs book, phone list, label maker
MBCALC.LBR	Spread sheet program in MBasic
MINDER.ARK	Personal reminder/notices/multi-user
MIX.LBR 	R.F. intermodulation products calc.
MONEY.LBR	Financial Utilities for H/Z-89
N41.LBR 	Converts numbers to hex, bin, dec
NEWJ1.LBR	Julian Calendar Converter
NOTEPAD.LBR	Cursor-oriented note pad utility
PHONE.LBR	Search phone book file for argument
PHONE3.LBR	Fast little black book/notebook prog
PROJANAL.LBR	Discounted cash-flow model
ROLDEX31.LBR	Databae for names and phone numbers
ROLO10.LBR	Database for names & phone numbers
RPN.LBR 	Reverse Polish notation calculator
RPNC.LBR	HP calculator simulator for CP/M
RPNCALC.LBR	RPN calculator - w/command stg.
RPNMF14E.LBR	RPN floating point calculator
RULE78.ARK	Amortize by the Rule of 78's
SCHEDULE.LBR	Schedules events or activities
STARDATE.LBR	Calendar/almanac/astronomical calc.
TIMEZONE.LBR	Outputs the time for 20+ places
TVIRPN.COM	RPN calc. for Apple, Soroc, Televid.
UNIT.LBR	Units conversion program
UNITS.BUG	Bug in UNITS conversion program
UNITS.LBR	Convert units of measurements
WEEKDAY.LBR	Vid-oriented Julian Date calculator
WINDCHIL.BQS	Calculates wind chill factor
WORLDTIM.COM	World time calculator

    Library  9. Directory Utilities

ABUSER84.LBR	Changes user number without copy
CD7.AQM 	RCP/M Change Directory command
CDIR11.LBR	Compare directories of two disks
CFA10.LBR	Change file attributes/user area
CHDIR.LBR	Name disk user areas - like MSDOS
CHG11.LBR	UNERAse or change user num. of file
CU.LBR		Move files to another user area
D-42A.LBR	Display changes in a directory
D-V100.LBR	Z80 directory display w/options
D2.COM		Osborne 52-wide sorted directory
DA22.LBR	Directory lister also sets attribute
DDMP11.LBR	Dumps disk directory in Hex/ASCII
DIR-FIX.AQM	Corrects CP/M 1.4 directory entry
DIR.BAS 	BASIC directory menu display
DIR1ST31.LBR	Sorted DIR prints 1st line of file
DIRDIRS2.LBR	DIR command for CCP replacements
DIREC.LBR	Turbo Pascal directory utility
DIRF37KP.LBR	DIR list includes description
DIRF38HZ.LBR	HZ19/89 DIR list with descriptions
DIRFREE.LBR	Reports directory status
DIRR7.LBR	CP/M2.2 & CP/M-Plus sorted directory
DIRREP21.LBR	Repair kit for disk directories
DIRSIZE.LBR	Disk directory file count
DL.LBR		Unix-like replacement for CP/M's ERA
DLQ.LBR 	Deletes squeezed files after USQ
DLZ2.LBR	Delete ?Z? files after UNCRunching
DR24.LBR	Alphabetical directory lister
DS-UTIL2.LBR	DateStamper utilities (update #2)
DS.LBR		Display CP/M directory, w/ filesize
ERAX12.LBR	Extended erase program with query
FCOM11.LBR	Super Directory for hard-disk
FILE23.LBR	Finds files on all drives/user areas
L-C/DIR.LBR	Lower-case directory utility
LABEL.AQM	Prints a directory on any size label
LI.LBR		List dir/copy NorthStar disk to CP/M
MATCHDIR.PQS	Compares 2 DIRs, Prints unique files
MDIR21.AQM	Sorted DIR - files in all user areas
MENU.BQS	MBASIC directory menu
PRNTDF10.LBR	Keep track of user group disks
PROTECT.LBR	Set file protection & attribute bits
RDIR15+.LBR	DIR gives transfer time at baud rate
RENAME.LBR	Selective multiple REName
RENEXT11.LBR	Renames file extensions only
RM104.ARK	A UNIX-like file deletion program
RN21.LBR	Wildcard rename utility
SAP60.LBR	Sort/pack CP/M disk directory
SAPP20.LBR	Sorts and packs CP/M directory
SD137.LBR	Super Directory, does LBRs, ARKs
SD22.COM	Simple sorted directory lister
SDPAT130.LBR	SD COM file, patch to change # drive
SDZD136.LBR	Super Directory w/Z80DOS date/time
SFILE32.LBR	SuperFILE find for dir, ARC, ARK
SSD.LBR 	Simple sorted directory programs
WIPE.PAS	Routine to erase all .BAK files
WIS201.LBR	Whereis a file - search drives/users
XDIR3-12.LBR	CP/M 2.2 extended directory display
XRASE33.LBR	UNERASES files mistakenly erased
ZDR.LBR 	Small disk directory program
ZX31.LBR	A horizontal directory lister

    Library 10. Disk Cataloging

CAT2.LBR	Wild card search MAST.CAT for files
CATALOG.LBR	Disk file cataloging system
CATLA10.LBR	Catalog library and archive files
CCAT26.LBR	Compare two MAST.LST for duplicates
CRUSER.LBR	Cross-ref. MAST.CAT by User area
DB/MAST.LBR	dBASEII analysis of disk catalog
DCAT10.LBR	A MCAT cross reference utility
DIRFDOC.LBR	Captures disk directory to text file
DISKDIR.COM	Disk cataloger like MCAT and XCAT
DISKER21.LBR	Keep track of files on diskettes
DISKNUM.LBR	Create null file -disk.nnn numbers
DSKLABL1.LBR	Print label showing files on disk
DSKNUM12.LBR	Create dsk lbl names for MCAT/FATCAT
FATCAT24.CHG	Change the delimiter (|) for FATCAT
FATCAT24.LBR	Buffered multi-disk catalog program
FATCAT2X.BUG	FATCAT problem report and fix
FATCATSB.LBR	Disk cataloging with SB180 w/ZCPR3
FML.LBR 	Fast catalog and phone list search
HCAT.LBR	Disk cataloging program
IBACK.LBR	Backup/Restore hard disks
LCAT20.LBR	Library Cataloging Utility ver 2.0
LCATCODE.LBR	A library catalog system
LSTOOL11.LBR	Read two MAST.LST to show dup files
M-XCAT5.MSG	Announcement of enhanced MCAT/XCAT
MCAT45.LBR	Catalog maintenance utilities
MCAT505.LBR	Enhanced disk cataloging program
MULCAT20.LBR	Multiple disk update disk cataloguer
NULL.LBR	Create -DISK.number files for CP/M+
NUMBERIT.LBR	Prepare disks for cataloging program
ORGANIZR.LBR	'The Organizer' disk file cataloguer
STAMP.LBR	Time catalog of files on disk
VOLNUM.LBR	Labels disks to use with cataloging
XCAT502.LBR	Enhanced disk cataloging program
XCATN502.LBR	No-clock version of XCAT502, & fixed
YAYANC02.LBR	Disk catalog program in 'C'

    Library 11. Disk Utilities

1KUTILS3.LBR	Small, fast, 1K utilities
ALLOC3.LBR	Displays allocation bit map for disk
ALTBW1.LBR	Alternate disk formats for Bondwell
ALTDRIVE.LBR	Dynamic re-configuration of DSKDRV
ANYDISK.LBR	Examines/Modifies CP/M disks
ARCOPY.LBR	Incremental backup of files utility
ARCOPY21.LBR	File copy utility
B29V304.ARK	Enhanced SWEEP-like utility
BAK11.LBR	Erases BAK files from disk
BAKUP23A.LBR	Backup files from harddisk to floppy
BBACK622.LBR	System to archive hard disk files
BD04.LBR	Find bad disk sectors and files.
BU-DDJ-F.LBR	Hard disk back-up utility
BU11+.LBR	Hard disk backup utility
BU20.LBR	An incremental backup program in 'C'
BWFMT.LBR	Bondwell 12/14 format programs
CCF.LBR 	Combine, copy, move, reverse files
CERTIFY.LBR	Disk certification utility
CHECK28.LBR	Copy, delete, compare directories
CHGDISK.LBR	Reconfigure Advent RAMdisk
CKCRC11.LBR	Calculates and validates CRC of file
COMP13.LBR	Compares two COM (binary) files
COMPARE3.LBR	Compare and verify two files
CP31.LBR	File copy utility
CPMORE2X.ARK	Integrated set of CP/M 2.2 utilities
CPYFIL15.LBR	Selective file copy program
CPYFST43.LBR	Fast disk to disk copy
CPYFSTU.LBR	Universal fast diskette copy program
CSWEEP3.LBR	File copy utility
DAMSPT21.LBR	Recovers data in bad sectors
DD17.LBR	Z80 disk directory utility
DDDTV802.LBR	TeleVideo 802 disk drive diagnostic
DED.LBR 	Edits disk by track/sector
DISK-FIX.LBR	Disk maintenance, recover files, etc
DISKFILL.LBR	Wipe out all unused disk data space
DISKX11.LBR	A comprehensive disk exercisor
DMAP.LBR	Displays disk allocation vector
DOSTOCPM.ARK	MSDOS to CP/M file transfer for H89
DS21DOC.LBR	Inspect floppy discs for bad sectors
DS21PAS.LBR	Source for bad sector finder/recover
DSKFRMTS.DQT	Defines many disk formats
DSKLBL16.LBR	Makes labels for your disk
DU-TUTOR.AQT	User's guide for DU disk utility pgm
DU-V89.LBR	Disk Utility read/write track/sector
DU88.LBR	Disk Utility read/write track/sector
ED405.FZX	Fix to EDFILE
ED409.AZM	Fix to EDFILE
EDFILCNF.AZM	EDFILE terminal configuration file
EDFILE.LBR	Disk file editor
EDFILE3.LBR	Disk file editor
EF19.LBR	EDFILE for the H19/H89 function keys
ERADIR10.LBR	Erases the directory of CP/M disk
ERR11.LBR	Returns disk error count for Heath89
EXRDTRAK.LBR	Osborne Exec. read disk track util.
FBAD70.LBR	Checks/locks out bad tracks on disks
FILELOCK.LBR	Protect files on a shared system
FIP.LBR 	User oriented file interchange pgm
FIRE12.LBR	Cleans up fragmented disk
FIX.LBR 	File fixer/UNERAse/directory check
FSDU.BUG	Describes a problem with FSDU
FU-V13.LBR	Full screen binary file editor
KLEAN20.LBR	Intelligent file erase utility
MAKE26.LBR	Change user area without moving file
MAP104.LBR	Displays all directory names
MEGADISK.LBR	Reads/writes foreign disks on AMPRO
MFT48.LBR	Copies files using one drive
NEWNC115.LBR	Copies like or unlike files
PACKHELP.LBR	Provides PACK list of disk directory
PATCH18A.LBR	Disk, file, memory manipulator
PATCH18A.PZT	Patches for PATCH18A
PCSWP05.LBR	Sweep through IBM-PC disks
PEEP13.LBR	A bidirectional file viewer
PGPRINT.LBR	Pascal program prints documentation
PIPE18.LBR	Fast file copier
QL41.LBR	Quick look typer for LBR/SQ/Crunched
QLOCK.LBR	Universal file encryption utility
RDMS233.LBR	Reads/copies files from MSDOS disks
RDMSDOS.LBR	Read/write MSDOS disks on CP/M sys.
READ-PC.LBR	Read MS/PCDOS disks on CP/M
READONLY.LBR	Protect against Trojan horse program
RECVR21.LBR	Recover files accidentally erased
REGROUP.LBR	Recover files when directory damaged
REPAIR.LBR	Repair a damaged disk directory
RESTORE2.LBR	Improve hard disk performance
RESTOREA.LBR	Re-org fragmented disk
RFTP101.LBR	Macros for ROFF text formatter
RPL.LBR 	Copy files with replace
SDCOPY.LBR	Single disk file copy
SETATT.LBR	Set READ-ONLY and SYSTEM attribute
SHOBLK11.LBR	Shows file allocated to track/sector
SMARTMOV.LBR	Smart file management utility
SODU82.LBR	Screen Oriented Disk Utility
SPEEDUP.LBR	A Disk DIR Cache for ANY system
SPY-8611.LBR	Investigates use of disk by program
SRW150.LBR	Memory/Disk inspector/modifier
SUPZAP33.LBR	Screen-oriented disk sec/trk editor
SWCOPY23.LBR	Single drive file copy program
SWITCH11.LBR	Hide files in user area 16
TAPDSK21.LBR	Backup disks to tape
TDSK201A.LBR	Backs up fixed disk to tape
TRANSF12.LBR	Transfer files to/from MS/DOS disks
UNERA33.LBR	Unerase accidentally erased files
UNERAZ11.LBR	Z80 file recovery utility
VOL-2.LBR	Creates/displays disk volume label
WASH15.LBR	Disk Maintenance Program
WHERFIND.LBR	Searches all directories for a file
WIPE12.LBR	Erases work files from disk drive
XFORMAT.LBR	Format/Copy utility for Xerox 820/1
XREN.LBR	Allows use of wildcards for REN
Z80DISK.LBR	Z80 utility to test disk drive
ZAP35.ARK	Screen-oriented disk sec/trk editor
ZCOPY21.LBR	Copy program uses ZCPR DU syntax
ZM13OVXE.LBR	ZMP13 overlay for Xerox 820-16/8
ZSCAN3.LBR	Read/alter/write each sector of disk

    Library 12. Editors/WP/Text Utilities

2UP.LBR 	Output text file in multiple columns
ADDLF205.LBR	Processes text file from non-CP/M
ALPHAT20.LBR	Embedded command txt print formatter
ANYCODE3.LBR	Use features of printer in WordStar
AVSCR254.LBR	Film/TV Producer's script formatter
B-SORT.LBR	Disk-based B-Tree file sort
BACKTOWS.LBR	Document file reformatter
BAWK.LBR	CP/M version of Unix AWK
BISHOW34.ARK	Bidirectional ASCII file viewer
BIT7.LBR	Resets bit 7 in text files
BOOKMAKR.LBR	Format files for print with WordStar
BOX1.ARK	Draw a Box around text
BSORT.LBR	Fixed length record combination sort
BSPAD.LBR	Store 20 items in this Scratch Pad
CHGCHAR.LBR	Changes characters in text file
CHOP-APP.LBR	Divide and put ASCII text back again
CHOP18.LBR	Chops large text files for editing
CHOP18A.LBR	Copies large files to smaller ones
CHOPVDE2.LBR	Split a file to process with VDE
CNTLH11.LBR	Text utility/fliterer
COMBINE.LBR	Merge multiple source files
CONCORD.LBR	Alphabetical list of distinct words
COPYF.LBR	Reorders overprinted lines
CRHRDSFT.LBR	WordStar <--> ASCII text conversion
CTYPE.LBR	Cleans up text file display
CUT10.LBR	CP/M file splitting utility
DATASAFE.LBR	Disp/save memory after editor crash
DEL-CR.LBR	Filter <CR><LF> from text file
DF-11.ARK	Compare 2 text files for differences
DF11R.LBR	Shows differences of two text files
DICTION.ARK	18,000 words for Spelling Checkers
DICTNU.LBR	Check text files for diction errors
DIF-SSED.DZC	Documentation for DIFF and SSED
DIF-SSED.LBR	Make file of differences btw 2 files
DIF22.LBR	Unix-style text file comparison tool
DLCR.LBR	File deletion utilities
ENDNOTE.LBR	Handles endnotes in a text file
ENSOFT2.LBR	Convert txt file to WS document file
EXPRES11.ARK	Full featured screen editor
EXTEND11.LBR	Enhanced append-string utility.
FANFLD13.LBR	Print on both sides of the paper
FANFLD14.LBR	Print on both sides of the paper
FANTEST.LBR	FANFOLD utility checks available TPA
FF.LBR		A WordStar add-on for screenwriters
FIG15.LBR	Analyzes readability of text files
FILPRINT.AZM	Make COM file to print ASCII file
FILT7-CR.LBR	Filter for typesetting
FILT7A.LBR	Filters garbage from ASCII text
FILTER32.ARK	Filter text files from other systems
FILTX2.LBR	Filter unwanted char from text files
FIND54.LBR	Find text string(s) in text file(s)
FINDLQ12.LBR	Find/view,Libary/not,sq'd/crunched
FINDU11.LBR	Find strings in SQed or regular text
FINREP28.LBR	Find and replace text utility
FIX18.LBR	Adds/removes tabs, CR, LF, from text
FLIPKEYS.LBR	Flip arrow keys on Osborne-1
FNCVT2.LBR	Format file for use with Magic Print
FOGINDEX.LBR	Gives grade level of a text file
FORMAT.IZF	A look at text format programs
FP.LBR		Find ASCII pattern (like GREP)
FT.LBR		A small text file creator.
FTNOTE14.LBR	Formats footnotes for WordStar files
GETSIZE.LBR	Display length of longest line
GF13.LBR	Generalized Filter utility
GRAB.LBR	Find & grab paragraphs from WS files
GREP001.LBR	Searches a file for a given pattern
GTXT11A.LBR	Conv. text to COM for easy display
HELPER.LBR	Converts text file into COM file
HRM-CUTL.LBR	Sort/merge/split/uniq text tools
I-21.LBR	Small bi-directional text display
INDEX85.LBR	Document file indexer
JUKIPATC.WZ	Juki 6100 custom patches for WS
JUSTIFY.LBR	Justify text files with even margins
KEYSTOWS.AQT	Using macros in WordStar
KEYWORD.LBR	Prints a list of words in a file
KLIST16.ARK	Relational list maker
KMINCE.LBR	KeyPad editor for CP/M-68K Mince
KWIKLIST.LBR	Menu-driven utility for printing
LD400.LBR	Flexible ASCII file viewer
LINEPAGE.LBR	Page formatter for use with DBL
LIT.LBR 	Convert test file to COM file
M-MERGE.LBR	WS MailMerge example templates
MAGIC.LBR	Prints large letters to disk, etc.
MAILMRGE.DQC	WordStar's MailMerge explained!
MERGETUT.LBR	Tutorial for WordStar's MailMerge
MESSAGE.LBR	Merge with text to make COM file
MLIST50.LBR	Type multiple text files w/buffering
MMERGE.LBR	Merge names, titles, adrs, into docs
MOREWS4.TXT	WS4 -- good, with a few bugs
MSG.LBR 	Enter messages for uploading to BBS
MSG1U.LBR	Enter messages for uploading to BBS
MYTYPE.LBR	Epson-compat. printer typewriter pgm
NEWRITKP.LBR	Formatter for TOUR20
NUMBER.LBR	Add numbers to lines of text file
OBW.LBR 	Outliner for the Bondwell 2
ODDEVEN.PQT	Two-sided printing with WS & NewWord
OM.LBR		Outliner for the Morrow
OSB1WS4.LBR	Patches for the Osborne1 and WS4
OUTLINE.LBR	Used with WordStar, produces outline
OUTLINER.LBR	Text outline processor
OUTLN11.LBR	Makes outlines of ASCII files
PAIRP.LBR	Finds un-paired chars in PW files
PAIRX131.LBR	Check for unmatched WS ctl chars
PAMPH13.LBR	Make folded pamphlet from WS text
PASTE3.LBR	Join two files side by side
PATVLU11.AZM	Use sweep-like utility with CP/M 2.2
PF-INST.IQF	Install printer for Perfect Writer
PFCTWRTR.LBR	PD Utils for Perfect Writer.
POW.LBR 	Processor of Words - test formatter
PPG213.LBR	Print DOC, source, text files
PRFCTDIR.LBR	Get sorted DIR in Perfect Writer
PRN36.LBR	Prints graphic characters in WS file
PRNTXT15.LBR	Make COM files from text files
PRTCOL10.LBR	Format text into two or more columns
PWLINE25.DZC	Use 25 lines in Perfect Writer
PWLKWS23.ARK	Make Perfect Writer WS-compatible
PWMENU2.LBR	Menu replacement with Perfect Writer
QL41-XE1.LBR	QL set up for Xerox systems
REFIND2.ARK	Keep track of references
REFLIST.ARK	Create bibliography in WordStar
REFLIST.LBR	Create bibliography/reference lists
REFS13.LBR	Find references in Scientific manusc
REPLACE.LBR	Replace a string in a text file
REPLAY.LBR	Displays/filters captured files
RESCUE.LBR	Turbo Pascal program to recover text
RESQ17.LBR	Recovers text in RAM after crash
RNF13.LBR	Text formatter/word processor
RNF13SOR.LBR	Source for the RNF text formatter
ROFF4161.LBR	Powerful customizable text formatter
ROFFMRGE.TZT	Merge letters using ROFF4 and dBASE
SAVESTAR.LBR	Save WordStar text from system crash
SCAN12.LBR	A bi-directional text scroll utility
SCANC.LBR	Textfile search utility. Multiple.
SF11.LBR	Show a text file with options
SIDEWAYS.CZM	Print files sideways on Epson FX80
SIMPLE.ARK	Printer driver for WordStar 4.0
SKIM.LBR	Removes non-printing chars from text
SOFTEN.LBR	Convert ASCII text file to WordStar
SORTFILE.LBR	Sort for ASCII text files
SORTMK22.LBR	General purpose text file sort
SORTTEXT.LBR	Turbo Pascal ASCII text sort utility
SORTV-14.LBR	Sorts ASCII text files
SORTV-15.LBR	Variable length record sort
SPELLER.LBR	Spelling checker for text files
SPELLM20.ARK	Spelling checker with dictionary
SPLIT45.LBR	Split large files into smaller ones
SPLTFILE.LBR	Splits up long text file
SPLTFST2.LBR	Break up large text files
SR2.LBR 	String search and replace utility
SRT12A.LBR	Memory/disk-based ascii text sort
SSED22.LBR	Stream editor used with DIF
SSORT.LBR	Merge (disk) sort text utility
STRIPA76.LBR	Text file conversion tool
STYX.ARK	A text editing system
SYA13.LBR	Save memory buffer after WS crash
TABS7.LBR	Sets tabs in text or asm files
TAIL20.LBR	Displays end of text file
TBL20.LBR	Table of contents for WordStar
TBLCTENT.LBR	Create WordStar Table of Contents
TED11.LBR	Powerful line-oriented text editor
TEK.LBR 	Displays ASCII text files paginated
TEXTCOM.LBR	Compares two text files
TEXTSAVE.LBR	Text salvager for Turbo Pascal & VDO
TIMESTMP.LBR	Insert time/date in text/asm files
TOCOL.LBR	Convert documents to multiple-column
TOUR10.LBR	Help collect and organize thoughts
TOURFIX.LBR	Converts tour20's files
TOURND.LBR	Post processor for TOUR
TP-DIF.LBR	Compare 2 text files for differences
TR11.ARK	Character translation utility
TRS80VDE.FZX	Installing VDE on a TRS-80 Mod 4
TRUE30.COM	A true 30 column screen chopper!!!
TS312.AQM	Date and time stamp text files
TTOOLS.LBR	Text formatting utilities
TURT100.LBR	Turbo Pascal graphic routines
TWA.LBR 	Run The Word Plus for all user areas
TWOSORTS.LBR	Memory and disk sort using quicksort
TX131.LBR	Text lister, squeezed/crunched files
TXT71.LBR	Turns text files into .COM files
TXTCOM2.LBR	Converts ASCII test to COM files
TXTL.LBR	Displays text using A-Z menu
TXTSAVE.LBR	Recovers text after editor crash
TYPEL36.LBR	Type ASCII files, squeezed, members
UNCAP12.LBR	Capitalize letters in text file
UNIX2CPM.LBR	Convert text files from Unix format
UNSOFT1C.LBR	Filters WordStar document files
VDE-PAT.LBR	Patches to VDE 2.63
VDE-SP26.LBR	VDE for formatting screenplays
VDE-Z3.PZT	Patch to VDE for use with ZCPR
VDE24HDR.LBR	Macro Key programming for VDE
VDE266.FIX	Fix to VDE 266 editor
VDE266.LBR	Small, powerful, text editor
VDE266AL.LBR	ALL files for VDE ver 2.66
VDE266SP.LBR	VDE266 modification for film script
VDECASE.DZC	VDE macro to reverse case of words
VDECUST.LBR	VDE customization for Morrow
VDEHLP.LBR	Help files for VDE 266 text editor
VDEMAC2.LBR	More macros for VDE text editor
VDEMACRO.LBR	Macros for VDE 2.62
VDENEC.LBR	VDE for the NEC8500 laptop
VDKCOM12.LBR	Convert VDE file to/from VDK file
VDO25B.LBR	Video Oriented Editor
VEDIT.IZF	VEDIT windowing demo screens
VEDIT/WS.LBR	WS like Key Layout for VEDIT
VERSION.LBR	Marks text files with version & date
VIEW43.LBR	Memory based View utility
VN-CZM1.LBR	Van Nuys Tools, first installment
VN-CZM2.LBR	Remainder of Van Nuys Bridge tools
VN-HZP.LBR	Help files for Van Nuys tools
VN-SRCZ.LBR	Source for Van Nuys Bridge Toolset
VPATCH10.LBR	Patch utility for VDO25B editor
WINDEX31.LBR	Creates indexes for WordStar files
WLISTM2W.ARK	A list of 20000 words M to W
WORDCT31.LBR	Counts words of a text file
WORDS910.LZT	Words NOT in WordStar 4's 'The Word'
WP-100.ARK	Text Editor w/Pascal Source
WP-100.LBR	WordPro word processor
WRDCOUNT.LBR	Count words in a text file
WS-BIBLE.DQC	WordStar patch locations 2.26,3,3.3
WS-COL12.LBR	Reformat pages in side-by-side col.
WS-MAIL.LBR	MailMerge for labels, envelopes
WS-SCRUB.COM	Convert WordStar files to pure ASCII
WS2ASCII.PQS	Strips high bit from WordStar files
WS2MW.LBR	Converts WordStar files to MacWrite
WS30MOD4.AQM	Memory mapped WS 3.0 for TRS-80 4/4P
WS33-B.DRV	WordStar patch to log in B: drive
WS3330.DQC	Patch points for WordStar 3.3 & 3.0
WS33MOD4.AQM	Memory mapped WS 3.3 for TRS-80 4/4P
WS3550.AZM	WordStar patch for NEC3550 printer
WS4-DIAB.FIX	Fix to WordStar 4.0 and Diablo
WS4-NS.LBR	NorthStar Advantage overlays for WS4
WS4.BUG 	WordStar 4.0 printer option problem
WS4.DQC 	Features of WordStar 4.0
WS4BW2.FIX	WS 4.0 fix for Bondwell 2
WS4CPM.NZW	List of features for WordStar 4.0
WS4MT.FIX	WS 4.0 fix for Morrow MT60/MT70
WS4SCRN.MZD	Mods to WordStar's screen control
WSCTRL-Y.IZF	Changing CTL-Y delete in WordStar
WSEPEM.TQT	Epson MX-80 emphasize ctl from WS
WSFAST24.LBR	WordStar speed-up patches
WSGEMINI.LBR	Gemini printer patch for WordStar
WSGUIDE.TQT	User's guide for WordStar
WSHADES.TXT	Windows for WordStar
WSKEY.LBR	Translate Heath keypad for WordStar
WSKEYS.MQS	Use of strings for WordStar
WSLOAD.LBR	Allows WordStar for several printers
WSMULCOP.LBR	Multiple printouts from WordStar
WSNEC.AQM	Customize WS for NEC PC-8023A ptr
WSNOT134.ARK	Produce footnotes with WordStar
WSNOTE.QZF	Quick reference list for wsNOTE
WSOVR12.AQM	Various patches to WordStar 3.3
WSPATCH.TQL	Address of WordStar patch points
WSPATNEW.3Z3	Patches for WordStar
WSPROPOR.DQC	Proportional spacing in WordStar
WSREFMAN.DZC	Customize WordStar's features
WSSCRIPT.PZT	WordStar patch for super/subscript
WSSIFT42.LBR	Filters WordStar files (Mbasic)
WSTIPS1.TXT	Useful tips for WordStar users #1
WSTIPS2.TXT	Useful tips for WordStar users #2
WSTIPS3.TXT	Useful tips for WordStar users #3
WSUNDERL.TXT	WordStar continuous underline/how
WS^Y.TQP	Patch to WordStar for line deletion
WT20.LBR	Bidirectional type/browse utility
XE2-WS4.LBR	Patches to WordStar 4.0 on Xerox
XEROX-WS.LBR	Wordstar improver-Xerox 820
Y21WS4.LBR	WordStar 4 patch traps CONIN/CONOUT
YANKBACK.TQT	Get back deleted WordStar blocks
ZDE-KP.LBR	Patch to Kaypros for ZDE cursor keys
ZDE10.LBR	Improved VDE editor for ZSYS & CP/M
ZGREP11.LBR	Searches a file for a given pattern
ZIPP.LBR	Joins up to seven ASCII files
ZMPOV3XE.FIX	Correcting error in previous upload.
ZTYPE11.LBR	Types with underlining and boldface

    Library 13. Educational

ABC.LBR 	MBasic program for learning alphabet
AVIAUTL1.LBR	Aviation Utilities
COMUFLT.LBR	Flight Planning Program
FLASH.LBR	Flash card program
FRENCH.LBR	French vocabulary quiz program
GERMAN.ARK	German vocabulary quiz program
GRADEBOK.LBR	Teacher's gradebook program
HEBREW.LBR	Hebrew vocabulary drilling system
KIDMATH.LBR	Addition/subtraction tutor
KIDSPEL1.LBR	dBase program to help teach spelling
LIFE-Z80.LBR	Z-80 vers of game of life. Fast.
MAGICSQ.LBR	Columns, rows, add up to same value
MATHPAC.LBR	Math learning tools for MBASIC
MDLPLNE2.LBR	Design and testing of model airplane
NETWORK2.LBR	RF filter/network/trans. line design
NOVICE1F.LBR	FCC NOVICE test video or printer
PR11.LBR	The Inversion of Large Matrices
RISES.ARK	Makes table of planet rise/set times
SPELLBE4.LBR	Spelling Bee - Educational game
TRAJ.LBR	Find trajectory for G1 projectiles
TTYPE3.LBR	Comprehensive touch typing tutor
TYPTEACH.LBR	Touch typing tutorial/measure speed

    Library 14. Forth Language

BLKTOFTH.ARK	F83 .BLK to .TXT conversion
CARDF83.TZT	Reference card for Forth 83
DES.BQK 	Data Encryption Standard in Forth
F83-20.MZN	Forth-83 Manual
F83V2-80.ARK	Forth-83 ver. 2 for CP/M-80
F83V2PT1.ARK	Forth-83 ver. 2, part #1
F83V2PT2.ARK	Forth-83 ver. 2, part #2
FIFO.BQK	Forth FIFO stack example
JUSTA.BQK	Forth-83 tools
SPREAD.BQK	Forth Spreadsheet
TOOLS.BQK	A selection of tools for FORTH-83
UNIFORTH.LBR	Sampler of Professional Uniforth
ZEDITOR.FQ3	Full screen editor for Forth

    Library 15. Games

21.BAS		Blackjack game 1-4 decks
ACEY-DUC.BAS	MBASIC card game
ADV-350.ARK	350-point Adventure game
ADV-550.ARK	550-point Adventure game
ADVEN-80.ARK	Interpreter for writing adventures
ADVENT.SZL	Walkthrough of Adventure Version B01
ADVENTUR.LBR	A four level adventure game
ALIEN.LBR	Space game with graphics
ALIENS11.LBR	Space Invaders arcade game
ALMAZAR.LBR	MBASIC 72 room adventure game
ANIMALS.LBR	Basic game learns as you play it
ARTILLRY.ARK	Cannon shooting game
ATLANTIS.BZS	Lost city of Atlantis adventure
AUSOPOLY.BZS	Australian version of Monopoly game
AXTAROT.LBR	Tarot card reading for the Actrix
BACCARAT.ARK	Card game of Baccarat - gambling
BAMBI.LBR	Bambi meets Godzilla
BARSOOM2.LBR	Text adventure game
BESTLIFE.LBR	Simulation of life
BIRTHDAY.BZS	Tells facts about your birthday
BJGAME.ARK	Black Jack card game
BKGM41.LBR	Full screen Backgammon
BLACJACK.ARK	Blackjack game in CBASIC
BLACKBOX.ARK	Find hidden object in black box
BLKJACK.LBR	Card game of Block Jack in MBASIC
BLOCK.ARK	Produces Block letters
BOGGLE.ARK	Number guessing game like Mastermind
BOMBRUN.BZS	Bomber pilot game
BOXING.BAS	Computer game of Boxing
BRIDGE.LBR	Card game of Bridge
BUTCH.LBR	Tell problems to Butch the Bartender
CAMEL.BQS	MBASIC source for chase game
CAMEL.COM	Compiled MBASIC chase game
CARGOMK2.LBR	Randomize the Cargo for STARSHIP
CASTLE.BAS	Wizard's Castle game
CASTLE.DOC	Documentation for CASTLE.BAS
CHICKEN.LBR	Two-player video game
CHUCKLCK.ARK	Dice rolling game
CIA.BZS 	CIA adventure game in MBASIC
COOKIE.LBR	Don't forget to feed this monster
COREWARS.LBR	Two player-written computer game
CORPORAT.BZS	Corporate president game
CRAZY-8.BZS	Crazy Eight card game in MBASIC
CRIB-PAS.LBR	Cribbage card game in Turbo Pascal
CRYPTO11.LBR	Programs to help solve cryptograms
DARTS.BAS	Computer game of Darts
DEEPSPCE.BZS	Tactical combat in deep space
DND-KP10.LBR	Adventure game of DND
DND.ARK 	Dungeons & Dragons for Xerox 820-II
DOD.LBR 	Break into DOD computers game
DODGE.ARK	Dodge/destroy the meanies game
DOGSTAR.BZS	Space adventure game
DUKEDOM.LBR	Help run the Kingdom in this game
ECLIPSE.LBR	Predict the eclipse of Moon and Sun
ELIZA.LBR	This is ELIZA, the doctor
ETHICS.LBR	Arcade game
FIGHTER.BZS	Space craft adventure game
FLIFEH89.LBR	Z80 game of LIFE for the H89
FOOTBALL.LBR	Game of football
GAMELIFE.LBR	Fast Z80 machine language LIFE game
GAMN-KIT.LBR	Backgammon game, with source, config
GENHOSP.LBR	General Hospital - Adventure game
GO-20.LBR	Surround enemy's territory
GODS.BQS	MBASIC Text adventure game.
GRAFTREK.LBR	Startrek for the Heath H89
GTWY101.ARK	Online GATEWAY simulation (NORAD)
HANGMAN.ARK	Classic game of Hangman
HOBBIT.BQS	Simple MBasic text adventure
HOCKEY.BQS	Simulated hockey game in MBasic
HORSERAC.ARK	Horse race game
JETSET2.LBR	Flight Simulator - 747 Jet Airplane
JUMBLE12.LBR	Do JUMBLE puzzles in newspapers
KENO.ARK	KENO, Las Vegas gambling game
KGAMES.LBR	Games for children aged 3 to 7
KISMET.ARK	Yahtzee-like dice game
KP-MONOP.LBR	An enhanced version of Monopoly-89
LADDER.LBR	Cursor-oriented Donkey-Kong game
LADDER3.LBR	Three versions of Kong-like game
LADUP.LBR	New screens for LADDER game
LANDER.ARK	Try landing on a planet
LIFE.ARK	Classic computer game of LIFE
LIFE3D.LBR	Life in three dimensions
LIFEKP84.LBR	Game of Life for Kaypro
LIFEZ.LBR	Simulates cellular growth and death
LIFEZ2.LBR	Simulation of cellular growth/death
LOTTO.LBR	LOTTO game for making lotto numbers!
LUCKY13.LBR	Lottery number generator/checker
LUNNAR.BAS	Lunnar Lander game
MAZE.BZS	Makes maze puzzle games on printer
MAZE.LBR	Maze generation algorithms
MCHASE.LBR	Maze Chase arcade game
MEGAN.LBR	Conquer universe of Megan
MILLE.LBR	MBASIC simulation of Mille-bourne
MILLION.BZS	Become a millionaire in MBASIC
MISSLE2.LBR	Missile Defense, a space adventure
MOBY3.ARK	A whale of a chase game
MONOP.LBR	Monopoly game
MONOPOLY.LBR	MBASIC version of Monopoly game
MORE-ADV.LBR	Adventure game development system
MYCHESS.LBR	Play chess against your computer
MYSTERY.ARK	Solve mystery in Mbasic adventure
NEWTREK.LBR	New version of MBASIC Star Trek
NORAD20.LBR	Get access to Command Control Center
NUCLEAR.LBR	Nuclear Power Plant simulator game
NUMCNVRT.ARK	Converts from one base to another
OIL.ARK 	Inherit an oil company
OSGAMES1.ARK	3 action games for Osborne computers
OVERUNDR.ARK	Dice betting game
PACMAN.LBR	PACMAN arcade game
PACMAN89.LBR	MBASIC no-player screen graphic H89
PASGAME.LBR	25 games written in Turbo Pascal
PINGPONG.LBR	Ping pong game for Heath/Zenith 89
PLIFE.ARK	Classic computer game of LIFE
POKER.BZS	Poker card game for MBASIC
PQUACKEY.BZS	Beat the clock spelling game
QIX-SRC.ARK	QIX action video game - source code
QIXFREDM.LBR	QIX game for Freedom 100/200 term.
QIXGENER.ARK	QIX action video game - generic term
QIXMORRW.ARK	QIX action video game - Morrow MD60
QIXVT100.ARK	QIX action video game for VT100 term
QUATRIS.LBR	Version of Russian TETRIS game
QUATRIS2.LBR	Tetris-like Game in Turbo Pascal
QUBIC32.LBR	Tic-Tac-Toe game in a 4x4x4 cube
ROBOTS.LBR	Space adventure game
ROGUE17.LBR	Onscreen dungeon exploration game
ROULETTE.BZS	Win with Roulette game in MBASIC
SAHARA.LBR	Adventure game in the Sahara Desert
SNAKE.ARK	Get treasure before snake gets you
SP.LBR		Space adventure game
SPACEADV.BZS	Space adventure game
STARSHIP.ARK	A star-trading game in Pascal
STARTREK.COM	Super Star Trek game
STARTREK.LBR	New Star Trek game
STARTRK.LBR	Potent version of StarTrek
STARWARP.BQS	The voyage of the Starship in MBasic
STARWARS.BQS	Star Wars X-Wing fighter pilot game
SURVIVAL.BZS	Survive in space with MBASIC game
SWARMS.LBR	Stop the killer bees - MBASIC game
TAROT.LBR	MBASIC tarot card reading game
TELEPHON.ARK	Generates letters from phone numbers
THANKSGI.PZC	Happy Thanksgiving!
TRADE10.LBR	Interstellar trading game
TREK.ARK	Compiled version of Star Trek
TRIVIA.LBR	Question and answer game in MBasic
TRIVIA2.LBR	Trivial Pursuit word game
TRKPILOT.BQS	Federation Starship battle simulator
TWINKLE.ARK	Patterns of stars on screen
VADER.BZS	Battle Darth Vader in MBASIC game
VAMPIRE.BZS	Vampire's Castle adventure game
VEGAS11.LBR	A slot machine game
WAFFLE.LBR	A fortune telling program, and more
WAND2-2.LBR	WANDERER upgrade & new screens
WANDERER.LBR	Dig Dug like Game - get the diamonds
WHEEL1.ARK	Word related quessing game
WISECRAK.LBR	ELIZA-like conversational program
WORDSRCH.ARK	Wordsearch puzzle generator,goodxref
WORLDBR.LBR	Build Science Fiction solar systems
WUMPUS.ARK	Hunt the Wumpus game
Z80CHESS.LBR	Sargon Chess game (Z80)
ZANY232.AZT	A new RS-232 standard?
ZING.LBR	Simulation of bouncing ball
ZMNSTR22.LBR	MONSTER adventure game in MBasic
ZORK1.LBR	Solutions to problems in ZORK I
ZORKNOTE.TZT	Modifying Infocom CP/M game tcap's

    Library 16. Graphics/Music

BANNER.LBR	Print banners with large letters
BANNER03.LBR	Print large letters in 2 styles
DISKPLOT.LBR	Disk based plotter for large plots
FAXBIN.LBR	Data files prints satellite picture
FILEPL31.LBR	Print plots using Dot Matrix printer
FONT-FOG.LBR	Multiple font banner printer
GRAFMX80.LBR	Epson MX80/100 bit-image graphics
GRAFSTAN.TQT	Graphic notation for circuit diagram
GST01.LBR	Graphic Script Tools
GT-RECTS.LBR	Drawing demo for the GT180
H89MUSIC.LBR	Music on the H8 and H/Z89
HOOTERS.RLE	A great pair of hooters for RLE
MACREAD.LBR	Display MacPaint pictures on screen
MIDI.DQC	Questions/Answers on MIDI interface
OXEGE.LBR	Graphics for Osborne Executive
OXHI-RES.LBR	HI-RES graphics for Osb. Executive
PASTBORD.LBR	Printer graphics driver generator
PBBDR1.ARK	Print border with PasteBoard
PBDAT1.ARK	Graphic files for Pasteboard
PBDISK-1.LBR	Generate graphics files - 1 of 3
PBDISK-2.LBR	Generate graphics files - 2 of 3
PBDISK-3.LBR	Generate graphics file -- 3 of 3
PMASTER.LBR	Prints custom made signs, banners
RDUMP10.LBR	Display Run Length Encoded graphics
RLEPX.BAS	RLE picture reader for Geneva PX-8
SCRNGEN.LBR	Xerox 820-II graphics editor
SPIRAL.LBR	Draw spirals and circles on your ptr
WDRAW.LBR	Drawing Program

    Library 17. Help Files

ADV01.LBR	HELP file driver and interpreter
ASM2.HQP	CP/M 2.2 assembler help
BASCOM.HZP	Help file for MBASIC compiler
BDOS.HZP	Help file for CP/M BDOS
BIOS.HZP	Help file for CP/M BIOS
CBASIC2.HQP	CBASIC2 help
CPM+.HZP	Help for CP/M Plus commands
CPM2.HQP	CP/M 2.2 help
CPMTR.HQP	CP/M 2.2 transient programs help
DBASEBG.LBR	.HLP files for DBase
DU-V87.HQP	DU-V87 disk utility help
EBASIC.HQP	Public Domain EBASIC help
ED.HZP		Help file for CP/M ED
EX.HZP		Help file for EX
FORTRAN.HQP	Microsoft FORTRAN-80 help
HELP18U.AQM	HELP ver 1.8 UnSQueeze display .HLP
HELP18U.COM	HELP ver 1.8 with UnSQueeze - .HLP
HELP20.AQM	HELP ver 2.0 displays .HLP files
HELP20.COM	HELP ver 2.0 displays .HLP files
HELP20.HQP	HELP 2.0 (help for HELP program)
HJELP.LBR	Help utility works with libraries
L80.HQP 	Microsoft L80 linker help
LBRHLP1.LBR	HELP uses libraries/crunched files
LU300C.HQP	LU library utility help
LZED.HZP	Help for the Little Z EDitor
M80.HQP 	Microsoft M80 assembler help
MAC.HQP 	Digital Research MAC assembler help
MBASIC.HQP	MBASIC (Microsoft) help file
MLOAD.HZP	Help file for MLOAD
NULU.HZP	Help file for NULU
PHELP.COM	Prints .HLP (help) files on printer
PHELP.MQC	Prints .HLP files on your printer
PIP.HZP 	Help file for PIP
RATFOR.HQP	Help for the RATFOR preprocessor
SID.HQP 	SID debugger help file
SIO.HZP 	Help file for the Z80 SIO
SLRSYS.HZP	Help file for the SLR assembler
STAT.HZP	Help file for the CP/M STAT command
SWEEP.HZP	Help file for NEW SWEEP
SYSLIB.HZP	Help file for SYSLIB
TURBOPAS.HZP	Help file for Turbo Pascal
UNCR.HZP	Help file for UNCR utility.
USING-C.HQP	BDS-C help file
VDE.HZP 	Help file for the VDE editor
WS.HQP		Help file for WordStar
XLATE.HZP	Help file for 8080/Z80 translator
Z80MR.HZP	Help file for Z80 Macro assembler
Z8E.HZP 	Help file for Z8E debugger
ZDASM.HZP	Help file for ZDASM disassembler

    Library 18. Information/General Texts

-BBHELP.INF	Command Summary, Help, for GEnie BB
-FILES.DOC	Info about files on CP/M RoundTable
09TOP100.TXT	Top 100 CP/M Files as of 09/16/89
16/8HARD.DRV	Xerox 16/8 hard drive install notes
232APR88.GZG	Article for CP/M programming - April
232AUG88.GZG	Article for CP/M programming, August
232FEB88.GZG	Article for CP/M programming - FEB
232MAR88.GZG	Article for CP/M programming - March
232SEP88.GZG	Article for CP/M programming - Sept.
40MEGS/4.820	Add 40 Megs to the Xerox 820-II
802CLEAR.LBR	Get rid of status line on TeleVideo
820DIFF.IZF	Compares Xerox 820-1 Etch 1 and 2
AAN-8801.TZT	Using SCSI port for generalized I/O
AAN-8802.TZT	Intro to the AMPRO little boards
ALIAS.AQT	Discussion of CP/M Submit processors
AMSTRAD.INF	Information on Amstrad CP/M systems
ANTI-APS.CKT	Protect computer-repeated power loss
APR86.MQG	The $R/O (ReadOnly) News Magazine
APR87.MQG	The $R/O (ReadOnly) News Magazine
ARK-FILE.MSG	Memo telling use of ARK for CP/M
ASMBLY.TZT	Assembly language primer for CP/M
AUG85.MZG	The $R/O (ReadOnly) News Magazine
AUG86.MQG	The $R/O (ReadOnly) News Magazine
BACKSPAC.PAT	CP/M 2.2 backspace patch for DELETE
BACKUP.TZT	A look at backup philosophy
BANKSYS.DZC	Proposal to support banked memory
BASARITH.TZT	Simple arithmetic with MBASIC
BASIC-IO.IZF	How to do port-mapped I/O in MBASIC
BATTERY.BZR	Warning about batteries in computers
BAUD-BPS.IZF	The difference between baud and bps!
BBMSGOCT.TXT	CATCH UP ON OCTOBER'S BB MESSAGES
BBS-LAW.LZT	BBS-related laws of several states
BBS-SUIT.ARK	BBS user sues SysOp - suit details
BBSETIQ.TQT	A word about computer etiquette
BBSNOISE.TZT	Noise on BBS phone lines & modems
BBSSIGN.UZ	Concerns registering to a new BBS
BG-REVU.TZT	Review of BackGrounder II
BG-Z3.IQF	ZCPR3 with Plu*Perfect products
BGSCREEN.DZC	Info to BackGrounder screen drivers
BOGUS.MQM	Op-codes from dubious sources
BW2INFO.TZT	Port/pin info for Bondwell 2
BYONDZ80.TQT	Discussion of life beyond the Z80
CALLWAIT.DEF	How to defeat phone call waiting
CARE.TZT	Use and care of computers
CCINK.TXT	Info- Steve Ciarcia's new newsletter
CCPM-NOV.LBR	CP/M User Group Newsletter
CCPX2PLS.DOC	Draft design notes: CCP for CP/M-68K
CD-DISKS.TQT	CD ROM replacement for the hard disk
COMPRESS.TQT	Non-tech article on data compression
COMPRESS.TZT	Crunching and squeezing files
CONF0323.ARK	Conf. notes - CP/M ARK author
COPYRITE.LQW	Copyright law pertaining to computer
CP10.LBR	Discussion of Composite prime number
CPM-CC00.NDX	Index to Silveira's CP/M Connection
CPM-CC01.AZT	CC-01 -Finding the Best P/D Software
CPM-CC02.AZT	CC-02 -Communications Programs
CPM-CC03.AZT	CC-03 -Find Your Way Around an RCP/M
CPM-CC04.AZT	CC-04 -Basic Utilities
CPM-CC05.AZT	CC-05 -WordStar Utilities
CPM-CC06.AZT	CC-06 -Keys and Outlines
CPM-CC07.AZT	CC-07 -More Utilities for Writers
CPM-CC08.AZT	CC-08 -Where are they Now?
CPM-CC09.AZT	CC-09 -Games?  In CP/M?
CPM-CC10.AZT	CC-10 -Something New for CP/M
CPM-CC11.AZT	CC-11 -Tools for dBase II
CPM-CC12.AZT	CC-12 -Communications Update
CPM-CC13.AZT	CC-13 -Learning About CP/M
CPM-CC14.AZT	CC-14 -One for the Programmers
CPM-CC15.AZT	CC-15 -Any Signs of Life?
CPM-CC16.AZT	CC-16 -How Smart is SmartBrain?
CPM-CC17.AZT	CC-17 -Christmas Treats
CPM-CC18.AZT	CC-18 -New Tricks For The Old Dog
CPM-CC19.AZT	CC-19 -All the News from C to Z
CPM-CC20.AZT	CC-20 -ModemMail Does It All
CPM-CC21.AZT	CC-21 -More On ModemMail
CPM-CC22.AZT	CC-22 -Emulating CP/M
CPM-CC23.AZT	CC-23 -Hard disks for CP/M
CPM-CC24.AZT	CC-24 -The Wonderful World of Z
CPM-CC25.AZT	CC-25 -Z: The Saga Continues
CPM-CC26.AZT	CC-26 -Living with Z
CPM-CC27.AZT	CC-27 -Z: The Final Chapter -For Now
CPM-CC28.AZT	CC-28 -What the Future Holds
CPM-CC29.AZT	CC-29 -Living With a RAM Disk
CPM-CC30.AZT	CC-30 -Letters and Dream Machines
CPM-DIR1.NZT	CP/M directory structure discussion
CPM-DISK.ARK	Tips for systems with Hard Disks
CPM-DOS.AZT	Article on 8-bit/16-bit differences
CPM-FIDO.TZT	First CP/M-80 BBS with FidoNet!
CPM/TIPS.DZC	Internal workings of CP/M explained
CPMCONF.TZT	Quick look of future of CP/M
CPMDIR.INF	Info on CP/M directory
CPMDISC.ARK	Discussion on CP/M's past & future
CPMLIVES.OZ!	Details on ONEAC's CP/M ON! system
CPMPLUS.TZT	Review of CP/M-Plus
CPMSRC-H.LZT	Sources for CP/M Software
CRC.NZT 	Notes on calculating CRC values
CREDIT.TZT	Discussion about credit
DATABASE.TZT	General look at database programs
DATASTAR.TZT	Tip using FormGen and DataStar
DATESTMP.IQF	Time and date stamp CP/M files
DBEDIT.TZT	dBASE II editing tips
DBEDITOR.TZT	Limitation of dBASE command editor
DBFULL.TZT	dBASE II DISK IS FULL message
DBJOIN.TZT	Bug in dBASE II JOIN command
DBPACK.TZT	Packing dBASE files to save space
DEALERS.BZ2	BackGrounder dealer list
DEC85.MZG	The $R/O (ReadOnly) News Magazine
DEC86.MQG	The $R/O (ReadOnly) News Magazine
DECEMBER.ARK	CP/M User Group newsletter - Dec.
DIABLO.D25	Good deal on Diablo printer
DISCOUNT.GNE	New CP/M user GEnie sign-up discount
DISKDIAG.TZT	Diagnosing disk drive problems
DISKFIX.TZT	Diskette problems after a repair
DISKFLIP.DQC	Why NOT to use backside of floppys
DJ+QUME.FIX	Problem with DJ2D board
DJ2D-CTL.FIX	Problem with the DJ2D controller
DJSYSGEN.FIX	Problem with Morrow's SYSGEN
DOSDISK.MZG	Plu*Perfect CP/M<-->MSDOS copy pgm.
DSKINFO.LBR	5-1/4 inch floppy formats list
DT42.TZT	New DT42 Computer from SemiDisk
EDFILE.AQT	Using EDFILE to modify a CP/M system
ENVTIP.TZT	Slipping envelopes into paper flow
ERASRCLN.MQG	Cleaning connectors using an eraser
ERS.DZC 	Info for CP/M-80 'B' for Epson QX
ETS180IO.DZC	Info on the ETS I/O board for SB180
EXTENTS.LST	List of file type extensions
FEB86.MZG	The $R/O (ReadOnly) News Magazine
FEB87.MQG	The $R/O (ReadOnly) News Magazine
FILENAME.IZF	Discussion of file utilities
FILES.TZT	Copying, printing, combining files
FLOPPY3.FZT	5 1/4 inch floppy formats list
FONE-ZAP.FIX	Phone/Modem lightning protection
FORMAT.TZT	Disk format options on Kaypros
FRIED.TZT	Recovering disks left in the sun
FUTURE.TZT	Comment on future of user groups
FUTUREOF.CQM	Discussion of the Future of CP/M
GEMAIL.HZP	Help for GEnie Mail system
GENESIS.ARK	King James Bible version of GENESIS
GENIECPM.INF	National CP/M RoundTable signup info
GENIECPM.SZG	SIG/M User Group disks on GEnie
GENIEIND.ARK	Complete index of GEnie services
GENIELST.BQS	Makes weekly/monthly GEnie file list
GIUNTI.TQT	Conference transcript of 10/29/86
GRUDGE2.DZC	PC-Z computer board fits into AT box
GUMMY.TZT	Warning about gummed labels
HAMINFO.LBR	Info files for Hams and SWL's
HARDDISK.TZT	How to treat hard disks
HARDRIVE.RZV	Installing a hard disk on the Adam
HAYS9600.TZT	Hayes Smartmodem 9600 baud info
HD64180.BQG	NEC 64180 - Z80 incompatibility bug
HD64180.WQ2	Info on NEC HD64180 chip - Rick Conn
HDISK003.DZT	Hard Disk Info (Cyls, Heads etc)
HEALTH.TZT	Video screens and your health
HEX.TZT 	Tutorial on hex and binary numbers
INTE8251.AZT	Info about the Intel 8251A USART
INTFRNC.DZC	Article on modem interfacing problem
JAN86.MZG	The $R/O (ReadOnly) News Magazine
JAN87.MQG	The $R/O (ReadOnly) News Magazine
JUL85.MZG	The $R/O (ReadOnly) News Magazine
JUL86.MQG	The $R/O (ReadOnly) News Magazine
JUN86.MQG	The $R/O (ReadOnly) News Magazine
JUN87.MZG	The $R/O (ReadOnly) News Magazine
LABALIGN.TZT	Label test routine for dBASE II
LAZY.TZT	Fewer keystrokes for lazy Kuggers
LBRS.TZT	Basic lesson on library utilities
LEFTOFF.TZT	Return to where you left off in edit
LIBRARY.CQL	Microcomputer disk libr. management
LIBRARY.TZT	Look at types of library files
LIBUTILS.TZT	Using NULU and LRUN with libraries
LIGHTNG.PQO	Protecting against lightning strikes
LOGDISK.TZT	Disk switching
LONGDOCS.TZT	Working with large files in WordStar
LSTAT.DOC	Implementing CP/M 2.2 list status
LUNCH.TXT	A look at CP/M versus MSDOS
MAGAZINE.CPM	CP/M Magazine, The Computer Journal
MAGNETS.TZT	Problems with magnets near computers
MAILLIST.IZF	USPS address correction svc.  Free!
MAR86.MQG	The $R/O (ReadOnly) News Magazine
MAR87.MZG	The $R/O (ReadOnly) News Magazine
MAY85.MZG	The $R/O (ReadOnly) News Magazine
MAY86.MQG	The $R/O (ReadOnly) News Magazine
MAY87.MQG	The $R/O (ReadOnly) News Magazine
MBASIC.FRE	Avoid MBASIC string cleanup delays
MBASPOS.TZT	Cursor positioning with MBASIC
MBASTIPS.TZT	Tips for MBASIC programmers
MDMHNTS.DZC	Setting up a new modem
MICROCIN.DQX	Index to Micro Cornucopia, Nos. 1-24
MICROSFT.FEB	Free Microsoft Language Publication
MNP-INTV.TQT	Interview w/author of MNP protocol
MODEMJAK.DOC	RJ11C versus RJ41S telephone jacks
MODEMS.TZT	Modems--What they are, how they work
MODMLOOP.MZG	Discussion of modem loop problems
MODULA2.RQS	Gives features of Z80 Turbo Modula-2
MSFTCALL.DOC	Explains CALL in Microsoft languages
MSOFTSAV.INF	Patch for Heathkit Microsoft product
MSSCONV.TZT	Article about manuscript conventions
MULTIHDR.TZT	Multiple-line headers/footers in WS
NAVIGATE.RT	Quick access to GEnie RoundTables
NECELF.TZT	Printer head assembly lubrication
NEW280.TZT	Info about a planned Z280 system
NEWBBS.HLP	Description of NEW GEnie BB features
NEWEI.MSG	Important message about Echelon
NOV85.MZG	The $R/O (ReadOnly) News Magazine
NOV86.MQG	The $R/O (ReadOnly) News Magazine
NSSUB.TZT	NewSweep problem with $$$.SUB files
NSWPTIPS.LBR	Tips about the disk Maint utility
OBSCURE.BZG	Problem with LT/VLU with attribute
OCT85.MZG	The $R/O (ReadOnly) News Magazine
OCT86.MQG	The $R/O (ReadOnly) News Magazine
OLDLADY.DZC	Modem mistakes may cause strict laws
ONKUG.INF	Description of recent text files
PAGEFIND.TZT	How to mark text for finding pages
PATCHIT.TZT	How to Patch a program file
PFLINES.TZT	Perfect Filer carriage returns
PHOTO.BUG	PHOTO program bug reports
POE-1-89.TXT	CP/M USER GROUP NEWSLETTER
POE-2-89.ARK	CP/M User's Group newsletter 2/89
POE-3-89.ARK	CP/M User group newsletter ASCII
POE-4-89.ARK	CP/M User Group newsletter
POE-7-89.TZT	7/89 Pieces of Eight contents
POE-8-89.TOC	8/89 Pieces of Eight contents
POE7-89A.LBR	7/89 Pieces of Eight articles
POE7-89P.LBR	7/89 Pieces of Eight programs
POE8-89A.LBR	8/89 Pieces of Eight articles
POST.TQT	Laws dealing with computer article
POWEROUT.TZT	Benefits of frequent workfile saves
PRIVACY.ARK	Electronic Communication Privacy Act
PRIVACY2.LBR	Elect. Comm. Priv. Act of 1986
PRIVCY2.BQL	Revised Electronic Comm Privacy Act
PRNTRASM.TZT	Writing a printer control program
PROTOCOL.TXT	New 1K XMODEM and YMODEM on GEnie!
PUBNOTES.TZT	BDOS patch for public files
PW.TZT		Printing PW documents
PW1.TZT 	Perfect Writer options/techniques
PW2.TZT 	Perfect Writer tips
PWCMND.TZT	Bypassing menu of Perfect Writer
PWCPM.TZT	Perfect Writer wildcards
PWPAGE.TZT	Perfect Writer page breaks
PWSCROLL.TZT	Moving around fast in Perfect Writer
PWSUGG.TZT	Perfect Writer quick printing
PX8INFO.LBR	Technical info for PX-8 laptop
QUIKIES.0Q3	A collection of useful CP/M tips
RCP/M-UG.PZN	RCP/M user's guide
README.AZT	Discussion of -READ.ME tradition
REALSYSP.DZC	Advice for new SysOPs
RESIDENT.TZT	Resident programs in CP/M
RPM-TOUR.IZF	Tour of RP operating system by XEDUX
RS232.HQP	Dealing with the RS-232 interface
RS232CBL.LBR	RS232 interconnect cable information
RTCSCHED.TXT	CP/M Real Time Conference Schedule
S100BOOK.INF	Interfacing to S-100 microcomputers
SAVE.TZT	Use of the CP/M SAVE command
SAVETIP.TZT	Recover data from memory
SB180.TQT	SB180 single-board CP/M computer
SB180WHO.MSG	Discussion of the Micromint SB-180
SBDRVJMP.DOC	Drive jumpering for the SB180
SCRENCLR.DOC	ADM-3A screen clear in CP/M files
SEARCH.TQT	Using the computer to find a job
SEP85.MZG	The $R/O (ReadOnly) News Magazine
SEP86.MQG	The $R/O (ReadOnly) News Magazine
SETDRU.AZT	Z80DOS, Public files, and SETDRU
SIEMENS8.IQF	Tips on Siemens 100-8 SSDD 8'' drive
SLRSYS.HQP	Detailed info on SLR assembly tools
SNYOSCRN.DQC	Sanyo 1200/1250 video commands
SPREAD.TZT	Spreadsheets for Data Analysis
SQSHINFO.DOC	Document of Squashed comression
STARLET.IZF	NEC Starlet battery recharger
STARWARE.TZT	Use of DataStar database software
STAT.TZT	What STAT does and how to use it
SUB-FIX.DOC	Running SUBMIT on other than A: driv
SUBMIT.IQF	A discussion of using SUBMIT.COM
SUBMIT.TZT	Tips using SUBMIT
SUNRISE.RZV	Review of Xerox 1815 laptop
SUPER8.LBR	Info/Assember for Super8 Zilog CPU
SUPRBDOS.IZF	SUPRBDOS install experiences/hints
TCJ.INF 	Info about The Computer Journal
TCJ34BMM.MZG	Bridger Mitchell's column -- TCJ #34
TCJ35BMM.MZG	Bridger Mitchell's column -- TCJ #35
TCJ37BMM.MZG	Bridger Mitchell's column -- TCJ #37
TCJ38BMM.MZG	Bridger Mitchell's column -- TCJ #38
THRUPUTS.DZC	Study of file transmission speeds
TOP689.LZT	Category/Topic List for BB
TRAGEDY.TQT	Woes of a modem addict
TRAKBAL.LBR	Adding a trackball to a Xerox 820-II
TV803FB1.LBR	Info about TeleVideo field bulletins
UCPM.ARK	'Universal' CP/M survey form
UCPM10.ARK	UCPM Universal CP/M Manual
UNDOCCPM.DOC	Program gotcha trashes directory
USERAREA.TZT	Tips on using user areas
USR-HAYS.TXT	U.S. Robotics/Hayes share technology
USR-S100.UPD	Mod corrects USR S-100 modem problem
USR-V32.LBR	USRobotics new V.32 dual std. modems
VIDTERM.LBR	terminal attribute Info
WAHZOO-1.TXT	Humorous Newsletter
WHATBAUD.DZC	Modem data terms defined/speed limit
WHATSA-T.WIT	Discussion of twits on RCP/Ms
WHITEHSE.PHN	Phone number to call the White House
WHYDOIT.TQT	Why one SysOP runs a Bulletin Board
WREN-II.CDC	How to get Control Data disk drives
WS/KAMAS.AZT	Using KAMAS with WordStar
WS4-NEW.RZV	Review of CP/M WordStar release 4.0
WS4CPM.PZ	Announcement of new CP/M WordStar
WSDEL.TZT	Patchs WordStar delete-line command
WSERA.TZT	Erasing files from WordStar
WSHEAD.TZT	Tips using header/footer in WordStar
WSHEADER.TZT	Making WordStar headers
WSMAGIC.TZT	Tips for speeding up editing tasks
WSMMTIP.TZT	Dot command bug fix for MailMerge
WSPOPT.TZT	WordStar's printer options
WSUNDER.TZT	Better underlining with WordStar
WSWLDCRD.TZT	Changing WordStar's search wildcard
WXMODEM.DQC	Windowed XMODEM improved protocol
XBIOS.IZF	Info on the new XBIOS for SB180
XRXOFFER.168	New Xerox 16/8 still available.
XYZMODEM.TXT	XMODEM/YMODEM/ZMODEM protocol info
Z280-GNE.IQF	Run CP/M twice as fast as IBM-AT
Z280-J88.LBR	Collection of messages about Z280
Z280INFO.MSG	Where to get Z280 cpu
Z33GCONF.TZT	Transcript of ZCPR 3.3 conference
Z80.DQC 	Discusses features of the Z80
Z80H.TXT	Speed up with the Z80H CPU chip
ZADAPTER.IZF	Info about ZEDUX Z280/Z80 adapters
ZARTICLS.LBR	Reviews from Morrow Owners Review
ZCOLUMNS.LBR	Morrow Owners Review ZCPR3 articles
ZCONFRTC.TXT	4-5-89 RTC Transcript with Jay Sage
ZCPR3.TZT	Pros and Cons of ZCPR 3.0
ZDAM-101.DZC	Maintain directories and catalog
ZEDUX.IZF	Info about ZEDUX Z280 adapter boards
ZEDUX280.DZC	A Z280 add-on card for CP/M systems
ZEDUX280.LBR	Information about ZEDUX Z280 board
ZEDUX280.MSG	More info about ZEDUX Z280 board
ZIP-APP.TZT	Application notes for ZIP files
ZOOM.INF	Zoom 1200/2400 modem timing problems
ZORKFACT.INF	ZORK STORY utility info
ZSIG-FOR.ALL	New ZRDOS/SB180/HD64180/ZCPR group
ZSYS.TZT	Comments on ZCPR version 3

    Library 19. Library/Archive Utilities

ADS.LBR 	Change date/time stamps of ARK files
ADS2.LBR	Change date/time stamps in ARKs
ARC-FILE.IZF	Technical description of ARC format
ARC68K.ARC	ARC 5.12 for CP/M-68K
ARK04.ARK	ARK/ARC archive file maker for CP/M
ARK04CON.ARK	Mod to ARK 4.0 prompts for Date/Time
ARK04FIX.ARK	Patches for ARK04 time/date overlays
ARKSETD.ARK	Manually set date for ARK'ing files
ARKTS.ARK	Time stamps for ARK files
BOOZ4CPM.ARK	Zoo archive extractor and lister
CCPXTEND.LBR	Execute COM files from Libraries
CPMSHAR.LBR	CP/M version of Unix SHAR/UNSHAR
CRLZHBET.LBR	LZH compression for CP/M
DELBR11.COM	LBR file extractor
DELBR11A.BUG	Bug report - DELBR program
DELBR11A.CQ	LBR file extractor source code
DLU12.PQS	A library utility in turbo pascal
LBRDSK23.LBR	Treat libraries as a logical drive
LBRUTIL.LBR	Date stamping for libraries (LBRs)
LCRC.LBR	Calculates and stores CRCs in LBRs
LDIR.COM	Directory lister for LBR files
LDIR23.LBR	Lists directory of LBR file
LDIRB14.LBR	Display LBR dirctory w/date/CRC/des
LRUN20.AQM	Run .COM files inside LBRs
LRUN20.COM	Run .COM files inside LBRs
LSTYPE.LBR	Print multiple files inside LBRs
LSWEEP13.LBR	Library SWEEP utility extract/view
LTYPE17.LBR	Types text files inside LBRs
LU.68K		LU for CP/M-68K. See XLU68K.LBR too.
LU300.DQC	Documentation for LU
LU310.COM	Library Utility ver 3.10 for LBRs
LU310.HLP	Help file for use with LU310
LU310.UPD	Update info on LU310.COM
LUDEF5.DQC	Internal structure of LBR files
NLUPATCH.MZC	Patches to NULU 1.51
NULU-OVL.LBR	Terminal overlays for NULU
NULU.PZT	Patch to speed up NULU start up
NULU15.NOT	A note from the author of NULU151
NULU15.WQ	Complete user's guide for NULU151
NULU151.COM	Machine lang. Library Utility pgm
NULU152A.COM	COM file of LBR maintenance utility
NULU152A.LBR	Library maintenance utility
NULUFIX.ASM	Bug fixes for NULU15.COM
NULUTERM.AQM	Terminal configuration for NULU151
PULL.LBR	Extract one file from a library
SETD01.LBR	Set dates for members of libraries
SETD22.LBR	Set dates for members of libraries
SETDDS.LBR	SETD overlay for DateStamper
UNARC.DQC	How to use UNARC.COM and UNARCA.COM
UNARC16.ARK	ARK/ARC file extraction utility
UNARC16.COM	Unarcer for Z80 processors
UNARC16S.ARK	Source code of UNARC version 1.6
UNARCA16.COM	Unarcer for 8080/8085 CP/M systems
UNPIT.LBR	Extract MAC PIT files on CP/M
UNZIP099.LBR	CP/M UnZIPper, full compat. w/PKZ101
XLU68K.LBR	Source and Documentation for LU.68K
ZIPDIR11.LBR	Display directory of ZIP files

    Library 20. MODEM & RCP/M Utilities,Mail/BBS

1KPACKET.DQC	Optional 1k packets in MEX and IMP
2CON.LBR	Dual-console adapter
4KXMODEM.DZC	4K-XMODEM protocol specifications
ADAMBYE5.LBR	Files needed to run BYE5 on the ADAM
AREACD21.LBR	Find region and state of an areacode
AUTOKMD.LBR	Update the KMD.LOG offline
AVATEXSM.TXT	MBYE mod for AVATEX modem
B5-CLOCK.LBR	Clock inserts for BYE5
B5-DSSW.IZS	SMARTWATCH insert for BYE510
B510FCB.FQX	Fix for installing BYE510 for CP/M 3
B5AD-1.IQS	Adv. Digital SuprQuad insrt for BYE5
B5AL-1.IQS	BYE5 Insert - Altos 5000 and 8000
B5AM-1.IQS	Ampro Little Board insert for BYE5
B5B2-2.IQS	BYE5 insert - Big Board II
B5C-DS.LBR	BYE5 clock insert for DateStamper
B5C-EVE.IZS	BYE 5.0 clock insert for Coleco Adam
B5C-ICM.IQS	BYE5 clock insert - Intersil ICM7170
B5C-LB36.IZS	BYE Clock Insert for Ampro BIOS Clk
B5C-SB.IZS	BYE5 clock insert for SB180
B5C-TV1.IQS	BYE5 insert - TeleVideo 803H
B5C8-2.IQS	BYE5 insert -- Commodore C128
B5CC-1.IQS	CCS2719/Sierra DatSci insrt for BYE5
B5CM-1.IQS	Cermetek Infomate 212a insert BYE5
B5CP-1.IQS	CompuPro Int3/4, SysSup1 insert BYE5
B5DP-1.IQS	Datapoint insert for BYE5
B5EA-3.IQS	BYE5 Insert - Eagle IIE Series
B5EP-1.IQS	Epson QX-10 insert for BYE5
B5EQ-3.IQS	BYE5 Insert - Insight Enterprises
B5H8-2.IQS	BYE5 Insert - Heath H89
B5HZ-1.IQS	Heath/Zenith 100 insert for BYE5
B5LO-1.IQS	Lobo insert for BYE5
B5MD-1.IQS	Morrow MicroDecision insert BYE5
B5MH-3.IQS	Morrow MD5, MD11, etc. insert BYE5
B5MH-5.IQS	BYE5 insert - Morrow
B5MM-1.IQS	MicroMint SB180 insert for BYE5
B5MT-1.IQS	BYE5 Insert - Memotech SDX-512
B5NH-1.IZS	BYE5 Insert - North Star Horizon
B5NS-4.IQS	NS Horizon & Advantage insert BYE5
B5NS-7.IQS	BYE5 insert-NorthStar Horizon/Advntg
B5OS-3.IQS	BYE5 Insert - Osborne OS-1
B5OV-1.IQS	Osborne Vixon insert for BYE5
B5OX-2.IQS	Osborne Executive insert for BYE5
B5PH-1.IQS	Philips P2000C insert for BYE5
B5R1-1.IQS	TRS-80 model I insert for BYE5
B5R2-1.IQS	RS II,12,16 & 16B insert for BYE5
B5R3-1.IQS	TRS-80 Model III insert for BYE5
B5R4-1.INS	TRS80 Model IV insert for BYE5
B5SB-2.IQS	InterTek Super Brain overlay for BYE
B5SP-1.IZS	BYE5 Insert - Adam with EVE SP1
B5SV-1.IQS	BYE5 insert - Servo-8 SBC
B5SY-1.IQS	BYE5 Insert - Sanyo 1000/1100/1200
B5TV-3.IQS	BYE5 insert - TeleVideo 802/803/804
B5TVH-2.IZS	BYE5 Insert - TeleVideo 803H
B5US-1.IQS	USRobotics S-100 modem insert BYE5
B5XE-1.IQS	Xerox 820 insert for BYE5
B5ZB-4.IQS	BYE5 Insert - Zorba
BAUDSET.LBR	Sets baud rates with IMP overlay
BBSUTIL.LBR	Utilities for RCP/M use
BMODEM.BAS	Simple XMODEM boot program in BASIC
BMODEM.DOC	How to configure BMODEM.BAS
BREAK.ASM	Subroutine sends BREAK using USART
BREAK.DQC	A clear explanation of BREAK
BUTIL2.LBR	MBASIC program to set BYE options
BW2-COMM.LBR	Communications set up for Bondwell 2
BW2XCON.LBR	External console driver for Bondwell
BY96HST.MZD	Mods to BYE510 for Courier HST modem
BYE5-INS.LST	All known BYE5 inserts as of 6/8/86
BYE520.LBR	Remote CP/M system, Tabby support
BYE8TRS.COM	BYE508 for TRS80 model 4 w/Montezuma
BYEATR.AZM	BYE for ATR8000 and SmartModem
BYERSX.ARK	A BYE replacement RSX
BYESTUFF.ARK	Supporting files for BYERSX
BYTIME31.AZM	Display user stats on RCP/M system
CBYE.LBR	Display maxuser maxdrive wheel bytes
CHAT46.LBR	RCP/M chat with SysOp utility
CIT3.MQD	Patches for Matt Wing's T-Room BBS
CITADEL.LBR	Multi-room bulletin board system
CONSOLE.AQM	Attaches a remote console to Osborne
CORK10.LBR	Console graphics filter for ZMP
CP409ACC.CZM	Kermit-80 ver. 4.09 - Access Matrix
CP409ADV.CZM	Kermit-80 ver. 4.09 - NS Advantage
CP409APM.CZM	Kermit-80 ver. 4.09 - Apple II/MMII
CP409BB2.CZM	Kermit-80 ver. 4.09 - BigBoard II.
CP409BBC.CZM	Kermit-80 ver. 4.09 - ACORN BBC
CP409BNS.CZM	Kermit-80 ver. 4.09 - NS Horizon
CP409BRA.CZM	Kermit-80 ver. 4.09 - Superbrain/aux
CP409BRM.CZM	Kermit-80 ver. 4.09 -Superbrain/main
CP409CA2.CZM	Kermit-80 ver. 4.09 - Cifer 1886/aux
CP409CA3.CZM	Kermit-80 ver. 4.09 - Cifer 1886/aux
CP409CI3.CZM	Kermit-80 ver. 4.09 _ Cifer 1886/VL
CP409CIF.CZM	Kermit-80 ver. 4.09 - Cifer 1886/VL
CP409COM.CZM	Kermit-80 ver. 4.09 - Comart
CP409CP3.CZM	Kermit-80 ver. 4.09 - Generic CP/M 3
CP409CPC.CZM	Kermit-80 ver. 4.09 - Amstrad CPC
CP409CPT.CZM	Kermit-80 ver. 4.09 - CPT-85xx
CP409CRO.CZM	Kermit-80 ver. 4.09 - Cromemco TUART
CP409DEL.CZM	Kermit-80 ver. 4.09 - Delphi 100
CP409DIS.CZM	Kermit-80 ver. 4.09 -Action Computer
CP409DM2.CZM	Kermit-80 ver. 4.09 - DECmate II
CP409DMV.CZM	Kermit-80 ver. 4.09 - NCR Decision
CP409DOC.ARK	Kermit-80 ver. 4.09 documentation
CP409GEN.CZM	Kermit-80 ver. 4.09 - Generic CP/M 2
CP409GNI.CZM	Kermit-80 ver. 4.09 - Video Genie
CP409H89.CZM	Kermit-80 ver. 4.09 - Heath H89
CP409H8Q.CZM	Kermit-80 ver. 4.09 - Heath H8 Quad8
CP409HOR.CZM	Kermit-80 ver. 4.09 - NS Horizon
CP409KPR.CZM	Kermit-80 ver. 4.09 - Kaypro
CP409LBO.CZM	Kermit-80 ver. 4.09 - Lobo Max-80
CP409MDI.CZM	Kermit-80 ver. 4.09 - Morrow Micro
CP409MM.CZM	Kermit-80 ver. 4.09 - Micromate
CP409MRL.CZM	Kermit-80 ver. 4.09 - Merlin/Rair
CP409NS.CZM	kermit-80 ver. 4.09 - NS Horizon/SIO
CP409OSB.CZM	Kermit-80 ver. 4.09 - Osborne 1
CP409OSI.CZM	Kermit-80 ver. 4.09 -Ohio Scientific
CP409PCI.CZM	Kermit-80 ver. 4.09 - Ithaca
CP409PCW.CZM	Kermit-80 ver. 4.09 - Amstrad PCW
CP409PX8.CZM	Kermit-80 ver. 4.09 - Epson PX-8
CP409RMF.CZM	Kermit-80 ver. 4.09 - RM 380Z w/FDS
CP409RMM.CZM	Kermit-80 ver. 4.09 - RM 380Z w/MDS
CP409SAN.CZM	Kermit-80 ver. 4.09 - Sanyo MBC-1100
CP409SB6.CZM	Kermit-80 ver. 4.09 - SB-180 6 MHZ
CP409SB9.CZM	Kermit-80 ver. 4.09 - SB-180 9 MHZ
CP409SCN.CZM	Kermit-80 ver. 4.09 - Screentyper
CP409SRC.ARK	Kermit-80 ver. 4.09 ASM source code
CP409TEL.CZM	Kermit-80 ver. 4.09 - TELCON Zobra
CP409TET.CZM	Kermit-80 ver. 4.09 - Systemmaster
CP409TLB.CZM	Kermit-80 ver. 4.09 - TRS-80 II Lfbt
CP409TM4.CZM	Kermit-80 ver. 4.09 - TRS-80 IV
CP409TOR.CZM	Kermit-80 ver. 4.09 - Torch Unicorn5
CP409TPT.CZM	Kermit-80 ver. 4.09 - TRS-80 II P&T
CP409UD.CZM	Kermit-80 ver. 4.09 - Morrow Micro
CP409USM.CZM	Kermit-80 ver. 4.09 - US Microsales
CP409VEC.CZM	Kermit-80 ver. 4.09 - Vector Graphic
CP409XER.CZM	Kermit-80 ver. 4.09 - Xerox 820
CP409Z00.CZM	Kermit-80 ver. 4.09 - Z100 - CP/M-85
CP409Z80.CZM	Kermit-80 ver. 4.09 - PC using Z80MU
CP438M.COM	Kermit-80 ver. 4.05-Research RM380Z
CP4PX8.COM	Kermit-80 ver. 4.05 for Epson PX8
CPMMODM.PQS	A Turbo Pascal modem program
DBBS50.LBR	dBASEII mail/msg/conference BBS pgm.
DIALOG.LBR	Automatic terminal dialog via modem
DRB845C.ARK	Bulletin board system with netmail
ECHOFILE.DZC	Description of ECHOMAIL protocols
EPSLINK.AZM	CP/M file transfer with Epson Geneva
FASTPBBS.LBR	Easy automatic compiling of PBBS
FFOR.AQM	Shows description of uploaded files
FIDO.NZT	Article about echomail for PBBS
FIX165.MEX	Fix for MEX-Plus ver. 1.65
FR21.LBR	File transfers using XON/XOFF
GATE.LBR	Terminal emulators
GENIENUL.MEX	MEX patch to get rid of 7F character
GETIT.ASM	Simple bootstrap modem program.
HAYESCMD.IZF	Command set for Hayes 2400b modems
HAYESCMD.TZT	S-registers used by Hayes modems
HBAUD11.LBR	Sets baud rates for Hitachi HD64180
HBBS-1.LBR	Bulletin Board Message System
HBBS-1SU.LBR	Supplemental library for HBBS
HBOOT3.BAS	MBASIC Xmodem boot program for H89
HEXLINK.LBR	Helps get that first modem program
HMODEM20.LBR	X/Y/ZMODEM for Heath/Zenith 89
HMSRC20.LBR	X/Y/ZMODEM for HZ89 source code
HP-FIX01.ARK	Fix to HBBS/PBBS bulletin board
I218-4.AZM	IMP Overlay - SB180 MicroMint
I2AC-2.AZM	IMP Overlay - Actrix computer
I2AD-2.AZM	IMP Overlay - Advanced Digital
I2AE-1.AZM	IMP Overlay - Action Enterprises
I2AL-3.AZM	IMP Overlay - Altos 8000
I2AM-4.AZM	IMP Overlay - Ampro Little Board
I2AP-10.AZM	IMP Overlay - various Apple CP/M
I2AS-2.AZM	IMP Overlay - Amstrad PCW-8256
I2B2-2.AZM	IMP Overlay - Big Board II
I2B3-2.AZM	IMP Overlay - Bondwell 2 Laptop
I2BT-4.AZM	IMP Overlay - Beehive Topper
I2BW-3.AZM	IMP Overlay - Bondwell 12/14
I2C8-2.AZM	IMP Overlay - Commodore C128
I2CC-5.AZM	IMP Overlay - CCS 2719/2830
I2CP-2.AZM	IMP Overlay - Compupro Interfacer
I2CR-1.AZM	IMP Overlay - Cromemco Tuart
I2CT-1.AZM	IMP Overlay - Cromemco TUART
I2DA-2.AZM	IMP Overlay - Davidge DST3-4/6
I2DG-2.AZM	IMP Overlay - Digital Group
I2DM-2.AZM	IMP Overlay - Dynabyte Monarch
I2DP-2.AZM	IMP Overlay - Datapoint 1560
I2DV-2.AZM	IMP Overlay - Datavue 3000
I2EA-2.AZM	IMP Overlay - Eagle II and III
I2EP-2.AZM	IMP Overlay - Epson QX-10
I2EQ-4.AZM	IMP Overlay - Insight Enterprises
I2FT-2.AZM	IMP Overlay - Facit DTC Computers
I2H8-5.AZM	IMP Overlay - Heath/Zenith 89
I2HZ-6.AZM	IMP Overlay - Heath/Zenith 100
I2LO-2.AZM	IMP Overlay - Lobo MAZ-80
I2MC-2.AZM	IMP Overlay - Molecular Series X
I2MD-2.AZM	IMP Overlay - Morrow MD3
I2MDA-3.AZM	IMP Overlay - Morrow MD3
I2ME-3.AZM	IMP Overlay - Morrow MD5/MD11
I2MIC-1.AZM	IMP Overlay - Multitech MIC 504
I2MM-4.ZZ0	IMP Overlay - MicroMint SB180
I2MO-3.AZM	IMP Overlay -- Morrow MD-3
I2MT-2.AZM	IMP Overlay - Memotech SDZ-512
I2NA-3.AZM	IMP Overlay - North Star Advantage
I2NC-2.AZM	IMP Overlay - NCR Decision Mate 5
I2NE-2.AZM	IMP Overlay - NEC 8801
I2NH-3.AZM	IMP Overlay - North Star Horizon
I2NS-6.AZM	IMP Overlay - North Star Horizon
I2OA-2.AZM	IMP Overlay - Otrona Attache
I2OS-5.AZM	IMP Overlay - Osborne OS-1
I2OV-3.AZM	IMP Overlay - Osborne Vixen
I2OX-2.AZM	IMP Overlay - Osborne Executive
I2PCC-1.AZM	Pertec PCC-2000 overlay for IMP
I2R2-2.AZM	IMP Overlay - TRS-80 Model II/12
I2R4-2.AZM	IMP Overlay - TRS-80 Model 4
I2RV-5.AZM	IMP Overlay - Racal-Vadic autodial
I2RV-6.AZM	IMP Overlay - Racal-Vadic modems
I2RY-1.AZM	IMP Overlay - Royal Alphatronics
I2S2-2.AZM	IMP Overlay - Sanyo 1200/1250
I2SB-3.AZM	IMP Overlay - Intertec Super Brain
I2SD-2.AZM	IMP Overlay - SD Systems SBC-200
I2SP-2.AZM	IMP Overlay - Coleco Adam/EVE SP-1
I2SS-3.AZM	IMP Overlay - CompuPro Sys Support 1
I2SV-2.AZM	IMP Overlay - SVI-238
I2SY-3.AZM	IMP Overlay - Sanyo computers
I2TD-2.AZM	IMP Overlay - TurboDOS 1.4x
I2TS-2.AZM	IMP Overlay - Timex-Sinclair 2068
I2TV-5.AZM	IMP Overlay - TeleVideo 801/802/804
I2US-1.AZM	IMP Overlay - US Robotics S-100
I2VB-3.AZM	IMP Overlay - Verbose only modems
I2VG-2.AZM	IMP Overlay - Vector Graphics 3/4
I2WM-3.AZM	IMP Overlay - WaveMate Bullet
I2XE-2.AZM	IMP Overlay - Xerox 820
I2ZB-2.AZM	IMP Overlay - Zorba
IMP-OVL.CZS	IMP Overlay customization notes
IMP-OVL.LZT	List of IMP (245) overlays
IMP-SP.LBR	IMP configured for the ADAM SP-1
IMP245.LBR	IMP modem communications program
IMP245V3.LBR	IMP 245 configured for Vector 3
IMP24DSC.FIX	Fix for the IMP disconnect problem
IMP2Z11.LBR	A ZCPR shell escape for IMP
IMP4MDS.LBR	Morrow MD overlays for IMP 245
IMPATCH2.LBR	Menu program to change IMP options
IMPSTEPS.TQT	Step by step instructions for IMP244
IMPSTRAD.LBR	IMP245 Amstrad PCW-8256
INSTALL.CZP	Setting up a RCP/M under CP/M Plus
INTPTCH3.LBR	Kaypro FASTTERM/INTTERM improvements
KMD23.LBR	File transfer program for RCP/M
KMDRSX.LBR	CP/M-Plus RSX enhances KMD use
KWINDOW5.DQC	Defines Kermit windowing protocol
LASTON10.LBR	Two new utilities for PBBS
LINKUP.TXT	Info for communicating using modem
LOGCALR.AQM	Logs RCP/M caller to LASTCALR file
LR.TZT		Info about HST Link Request frame
LUX101.LBR	Library/archive Utility eXtension
LUX80.ARK	Library/archive Utility eXtension
LUX8080.ARK	8080 version of LUX v4.3
LUXI80.LBR	RCP/M Library Utility for 8080/8085
M7-OVL29.LQT	MDM7xx overlay list - 05/11/86
M7AD-4.AZM	MODM700 overlay for Adam Syndmodem
M7H8-2-1.AQM	MDM7xx.com Overlay File For Heath H8
M7NC-1.AZM	Modem7 overlay for the NCR DMV
M7PCC-2.SZT	MODEM7.96 setup file for Pertec
M7PX-1.AZM	Epson PX-8 overlay for MODEM7
MADAM7.LBR	Modem program for Coleco Adam
MAINFRAM.LBR	Communicate with an IBM mainframe
MB-KMD11.LBR	Stand alone file transfer program
MBB2PBBS.LBR	Converts MBBS files to PBBS format
MBBS45A.LBR	Micro Bulletin Board System part #1
MBBS45B.LBR	Micro Bulletin Board System part #2
MBKMD120.LBR	File transfer with 1k/batch protocol
MBKMDOVL.LBR	Machine specific overlays for MB-KMD
MBKMDOVL.LZT	List of overlays for MB-KMD
MBOOT3.DOC	How to capture MBOOT3.ASM
MBOOTH89.ASM	Modem bootstrap program for H89
MBSIO-2.AQM	MBYE insert for Zilog SIO
MBYE45.LBR	Enables system to operate remotely
MCIMEX11.LBR	MEX READ files to call MCI MAIL
MDM7ADDS.AQM	MODEM7 overlay for Adds Multivision
MDMCABLE.TZT	Discussion of cables and RS-232
MEGALINK.DZC	Info on MegaLink Protocol
MEX-8BIT.MSG	Patch for MEX allows 8-bit term mode
MEX-BUFF.LBR	Instructions to adjust MEX buffers
MEX-EASY.DZC	MEX made easy - hints on use
MEX-SAVE.LBR	Saves MEX114 buffer when +DISK FULL+
MEX-SET2.DQC	Notes on using MEX READ files
MEX-STAT.FIX	Fix some MEX overlays for status rtn
MEX-TDOS.LBR	MEX customization for TurboDOS
MEX.HLP 	Help file for use with MEX114
MEX.HQP 	On-line help file for MEX114.COM
MEX114.COM	Ron Fowler's ModemEXecutive
MEX114.LBR	Ron Fowler's ModemEXecutive program
MEX114.PRN	Printer formatted MEX114 help file
MEX114.REV	Review of MEX, terminal/transfer pgm
MEX114FX.LBR	Bug fixes for MEX 1.14
MEX16.AZN	Features of MEX-Plus ver. 1.6
MEXART.LBR	Articles about MEX modem program
MEXBATCH.LBR	Useful read files for MEX
MEXCLS.PAT	Disable clearing the screen in MEX
MEXCMDS.WQ	User's guide to MEX commands
MEXHACKS.114	Useful patches for MEX114
MEXOVL10.LZT	List of 230+ overlays for MEX
MEXPAT11.AQM	User configuration patches for MEX
MEXPAT22.AQM	Configure MEX buffers and defaults
MEXREAD.AZT	Info about MEX read files
MEXRING.SET	How to set MEX for longer ring time
MEXST.COM	MEX114 ready to run on an Atari ST
MEXSTEPS.TQT	Step by step instructions for MEX114
MEXSUM.DQC	MEX documentation summary
MEXTEX.TQP	Using MEX to make text files
MLOAD25.CZM	Easy user overlay patching for MEX
MODEM.EP1	Insert for PCP on the Epson QX-10
MODEMPAT.AQM	Temp. control of console by modem
MODEMTP.LBR	XMODEM file transfer in Turbo Pascal
MODM700.AZM	Source - last public domain MODEM7
MODM700.LBR	Execs/Docs - last pub. domain MODEM7
MX-SM13A.AQM	MEX dialer overlay for Anchor modem
MX-SM13A.FIX	Using MEX with the Anchor modem info
MX114DOC.PQN	Printer formatted MEX114 user manual
MXC-DS10.ZZ0	MEXplus/DateStamper Clock overlay
MXH+OS16.LBR	Mex-Plus 1.65 overlays for Osborne 1
MXH-AM11.AQM	MEX+ overlay - Ampro Little Board
MXH-AM12.ZZ0	MEX Overlay - Ampro Little Board
MXH-CC18.AZM	MEX overlay - Columbia Commander
MXH-CPM3.AZM	MEX Overlay - CPM Plus
MXH-DELT.AQM	MEX overlay for Delta Products CPU
MXH-EP14.ZQ0	MEX Overlay - Epson QX-10
MXH-GB16.AQM	MEX overlay - CompuPro Interf. 3 & 4
MXH-MI11.AZM	MEX Overlay - PMC Micromate 101
MXH-NA13.AQM	MEX Overlay - NorthStar Advantage
MXH-OEX.LBR	Osborne Executive MEXplus overlays
MXH-VG4.AZM	MEX Overlay - Vector 4
MXH-VT.AQM	MEX/MEX-Plus overlay - VT180/Robin
MXH-VT36.AZM	MEX Overlay - DEC Micro VT180
MXM-2416.AQM	MEX 2400 bps auto fallback overlay
MXM-9610.ZZ0	MEX overlay for USR Courier 9600HST
MXM-ADAM.LBR	MEX overlay - ADAM, Full feature
MXM-CD10.AQM	MEX overlay - Concord Data Sys 224AD
MXM-CM11.AQM	MEX overlay - Cermetek/Infomate 212a
MXM-CQ11.AQM	MEX overlay - Concord Data sys 224
MXM-NE10.AZM	MEX Overlay - NEC N202BR-L1 modem
MXM-RT11.AQM	MEX overlay - RV 3451 autodial modem
MXM-RV16.AQM	MEX overlay - RV VA212 & 3451 modems
MXM-SC13.AZM	MEX Overlay - SwichCom Canadiana
MXM-SM15.AZM	MEX Overlay - Hayes SmartModem
MXM-SM16.AZM	MEX overlay for the Hayes SmartModem
MXM-UD10.AQM	MEX overlay - UDS 212 A/D modem
MXM-US13.AQM	MEX overlay - USRobotics S100 modem
MXM-USR2.AQM	MEX Overlay - U.S. Robotics 212A
MXMATR.ASM	MEX overlay for the SWP ATR8000
MXMATR.HEX	MEX Hex overlay for the ATR8000
MXO-AD13.AQM	MEX overlay - Adv Digital Super-six
MXO-AL10.AQM	MEX overlay - Altos series 5
MXO-AL11.AQM	MEX overlay - Altos 580
MXO-AM11.AQM	MEX overlay - Ampro Little Board
MXO-AS10.AZM	MEX Overlay - Alspa ACI-1
MXO-AT01.AZM	MEX Overlay - SWP ATR8000
MXO-AX11.AZM	MEX Overlay - Actrix computer
MXO-BB11.AQM	MEX overlay - Big Board I
MXO-BW13.AQM	MEX overlay - Bondwell 2
MXO-BW17.AZM	MEX Overlay - Bondwell 12 Computers
MXO-CT14.AQM	MEX overlay - CTS Companion modem
MXO-CY10.AZM	MEX for Motel's Cypher 68K/Z80 SBC
MXO-CZ10.AQM	MEX overlay - Int. Micro. CPZ-4800X
MXO-DB10.AQM	MEX overlay - Dynabyte DB 8/1
MXO-DM10.AQM	MEX overlay - generic 'dumb' modem
MXO-DM10.AZM	MEX Overlay - NCR DMV
MXO-DM20.AZM	MEX Overlay - NCR DecisionMate V
MXO-DP10.AQM	MEX overlay - Datapoint 1560
MXO-DT10.AQM	MEX overlay - Datec 212 modem
MXO-DV10.AQM	MEX overlay - Davidge DSB-4/6 SBC
MXO-EP30.AQM	MEX overlay - Epson QX-10
MXO-GB12.AZM	MEX Overlay - CompuPro I3/I4
MXO-H815.AQM	MEX overlay - Heath/Zenith H89
MXO-HD11.ZZ0	MEX Overlay - Hitachi HD64180
MXO-HP1.AZM	MEX overlay - HP-125 Series 100
MXO-HU11.AZM	MEX overlay - HZ-100/USR S-100
MXO-HZ20.AQM	MEX overlay - Heath/Zenith Z100
MXO-HZCM.AQM	MEX overlay - ASCII & BAUDOT (TDD)
MXO-I510.AZM	MEX Overlay - SSM IO-5 Board
MXO-IF10.AQM	MEX overlay - Informer Computers
MXO-II13.AQM	MEX overlay - Intersystems VIO
MXO-IM11.AQM	MEX overlay-Cermatek Info-mate modem
MXO-IN13.AQM	MEX Overlay - Intel 8251
MXO-LB22.AQM	MEX overlay - AMPRO Series 100
MXO-LB3.AQM	MEX overlay - AMPRO Little Board
MXO-LO15.AQM	MEX overlay - Lobo Max-80
MXO-MC10.AQM	MEX overlay - Magic Computer PC-88
MXO-MD11.AQM	MEX overlay - Morrow Micro Decision
MXO-MD20.AQM	MEX overlay - Morrow MD-3A
MXO-MD30.AZM	Mex Overlay - Micro Decision 3.0
MXO-MG10.AQM	MEX overlay - Mega Z80 SBC
MXO-MM10.AQM	MEX overlay - Morrow Multi I/O board
MXO-MO10.LBR	MEX overlay - MicroMint SB180 MOSRT
MXO-MR10.AQM	MEX overlay - Morrow Micro Decision
MXO-MW10.AQM	MEX overlay - Racal-Vadic MAXWELL
MXO-N815.AQM	MEX overlay - NEC PC-8801
MXO-NA1.AQM	MEX overlay - NorthStar Advantage
MXO-NE11.AQM	MEX overlay - NEC PC-8001A
MXO-NE88.AQM	MEX overlay - NEC PC-8001A
MXO-NS11.AQM	MEX overlay - NorthStar Horizon
MXO-OA11.AQM	MEX overlay - Otrona Attache
MXO-OC10.AQM	MEX overlay - Osborne COMM-PAC modem
MXO-ON2.LBR	MEX Overlay - ON! computers
MXO-OS22.AQM	MEX overlay - Osborne-1 serial
MXO-OX42.AZM	MEX Overlay - Osbourne Executive
MXO-PM22.AQM	MEX overlay - PMMI S-100 modem
MXO-PR10.AQM	MEX overlay - Penril AD Rixon
MXO-PX8.AQM	MEX overlay - Epson PX-8
MXO-PX8.DQC	Doc on customizing MEX for Epson PX8
MXO-QX10.AQM	MEX overlay - Epson QX-10
MXO-R213.AZM	MEX Overlay - TRS-80 Model II
MXO-RP10.AQM	MEX overlay - Tandy TRS-80 Model 4
MXO-RS20.AQM	MEX overlay - Tandy TRS-80 Model 4
MXO-RS21.AQM	MEX114 overlay - Radio Shack Model 4
MXO-RS32.AQM	Interrupt Driven TRS80 MEX Overlay
MXO-RS4P.LBR	MEX 1.14 overlays for TRS-80 4p
MXO-S511.AQM	MEX Overlay -- SSM IO-5 board
MXO-SB12.AQM	MEX overlay - Intertec Superbrain
MXO-SBS4.ZZ0	MEX overlay - Micromint SB180
MXO-SC10.AQM	MEX overlay - Novation SmartCat
MXO-SD10.AQM	MEX overlay - Sierra Data SBC-100
MXO-SM13.AQM	MEX overlay - Hayes/Hayes compatible
MXO-SM14.AQM	MEX overlay - Hayes/Hayes compatible
MXO-SMC.AQM	MEX overlay - Sony SMC-70
MXO-SN10.AZM	MEX Overlay - Sanyo MBC-1200/1250
MXO-SP2.AZM	MEX Port overlay for Spectravideo SV
MXO-SS10.AQM	MEX overlay - Adv. Dig. Super-6
MXO-ST.LBR	MEX114 overlay for Atari ST
MXO-SV10.AQM	MEX overlay - Servo-8
MXO-SX10.AQM	MEX overlay - Starplex Natl Semi
MXO-SY21.AQM	MEX overlay - Sanyo MBC-1000
MXO-TD30.AQM	MEX overlay - TurboDos comms chnls
MXO-TSA.AQM	MEX overlay - Toshiba T100
MXO-TV13.AQM	MEX overlay - TeleVideo TS-802
MXO-TV84.AQM	MEX Overlay - TeleVideo TS-804
MXO-UR13.AQM	MEX overlay - USRobotics S-100 modem
MXO-VP10.AQM	MEX overlay - Ventel MD212-Plus
MXO-VT11.AZM	MEX Overlay -- DEC Micro VT180
MXO-VTL1.AQM	MEX overlay - Ventel/Osborne Attache
MXO-WM10.LBR	MEX Overlay - Wave Mate Bullet
MXO-XE12.AQM	MEX overlay - Xerox 820/820-II
MXO-XE2U.AQM	MEX overlay - Xerox 820-II
MXO-XE36.AZM	Modem overlay for Xerox 820-II
MXO-Z321.AQM	MEX overlay - OSM Zeus 3
MXO-ZB11.AQM	MEX overlay - Zorba
MXTIMOUT.FQX	Timeout fix for MEX on slow disk
NEW06.AQM	Reports new uploads from KMD log
NEWBYE.MSG	Suggestion for improvements to BYE
NEWLOGON.INF	Recommended signon process for PC's
NODE104.LBR	PC Pursuit remote dialer (CP/M Plus)
NOTE2.LBR	Put a note in a COM file
NSD.ARK 	Terminal program in Zbasic
NSD.LBR 	Simple terminal program in ZBasic
NU-CLOCK.LBR	Clock inserts for NUBYE
NUBY-FIX.003	Fix to NUBY, remote access system
NUBY-FIX.0Q2	Fix to NUBYE101, Remote console pgm
NUBY-INS.LBR	Computer dependent inserts for NUBYE
NUBY-MOD.001	Mod to NUBYE, Remote access system
NUBY-MOD.002	Mod to NUBYE, Remote access system
NUBY-SUP.LBR	Supporting files/info for NUBYE
NUBYE101.FIX	FIX to NUBYE if running PBBS
NUBYE101.LBR	RCP/M modem remote console
NUC-TV.IQS	Clock insert for NUBYE on Televideo
NUKMD111.ARK	XMODEM/YMODEM file transfer for RCPM
NULLS10.ZZ0	RAS Null Set-Up Utility
OSUART.DZC	Improved access to Osborne 1 RS-232
OZBYE510.DQC	Installing BYE on the Osborne
PAKERR.TZT	Protocol over packet systems
PBBS-45.LBR	PBBS v4.5 Bulletin Board System
PBBS45FX.LBR	Fixes for PBBS version 4.5 BBS
PBBSUP45.LBR	PBBS 4.5 support files
PC2XEROX.LBR	Cable PC to Xerox 16/8 @ 19.2K baud
PCHAT11.MQC	Allow PBBS caller to chat with SysOp
PCPFAST.MZX	Easy PC Pursuit access with MEX114
PCPMEX22.LBR	MEX-Plus script files for PC Pursuit
PCPMX+20.LBR	MexPlus script using PC Pursuit
PHONWORD.LBR	Translate telephone number to words
PICKNUMS.LBR	Select numbers from MEX .PHN files
PICS-FIX.001	Fix to PICS 1.6
PICS16.ARK	Turbo Pascal BBS system.
PICSDEMO.ARK	PICS demo, doesn't use modem/clock
PICSDOCS.ARK	PICS BBS/file transfer RCP/M docs
PICSSUP.ARK	I/O and clock drivers for PICS
PINSTAL.CZM	PBBS install program
PMODEM.ARK	Turbo Pascal-based modem comm. pgm.
PORTPOLL.LBR	Poll an I/O port entered at keyboard
PREG451.LBR	User registration utility for PBBS
PROTOCL1.LBR	Discussion of modem protocols
PROTOCOL.DZC	Info on modem protocols
PSTAT453.LBR	Examine settings of PBBS
PTERM.LBR	Loader for Echomail on PBBS systems
PUBTOOL1.LBR	Search RCP/M off-line catalog
PUSER45.LBR	PBBS utility for user base
Q-SOURC2.LBR	MBASIC source for QBBS ver. 4 BBS
QBBS-UTL.ARK	QBBS Bulletin Board utilities
QBBS4-A.LBR	Compiled MBASIC Bulletin Board - A
QBBS4-B.LBR	Compiled MBASIC Bulletin Board - B
QKKER25.ARK	Turbo Pascal version of KERMIT
QT4-SB18.ZZ0	QTERM40 overlay for SB180
QT6-SB18.ZZ0	Qterm overlay for the SB-180
QTERM41E.LBR	Comm prgm with X/Ymodem and Kermit
QTERMAPP.LBR	QTERM overlays for Apple II CP/M
QTO-HP-1.AZM	QTERM Overlay - Hewlett-Packard
QTO-XER2.ZZ0	QTERM Overlay -- Xerox 820-II
QTO-ZB10.AZM	Telcon Zorba overlay for QTERM
QTP-XER2.AZM	Xerox820-II & 16/8 overlay for QTERM
QTPATCH.LBR	QTERM patch sources
QUOTE.LBR	Display random quote
QWIK4V1.LBR	Replacement for RCP/M FOR database
QXVT100.LBR	VT100 emulation for Epson QX-10
RAIDSYS1.LBR	Method of batch file transfers
RBBS40.LBR	Bulletin Board System in MBasic
RBBS4102.ARK	Remote Bulletin Board System in 'C'
READNEWS.LBR	Automate reading news on StarText
RINGNOT.LBR	Stop Password from answering phone
ROBUST.EOT	Improving EOT handling in XMODEM
ROS-MAC.LBR	I/O and Clock drivers for ROS
ROS1K.LBR	Adds 1k XMODEM protocol to ROS34
ROS34.LBR	Complete BBS/XMODEM/BYE in Pascal
ROSMISC.LBR	Supporting mods, enhancements to ROS
ROSUNCR.LBR	Type crunched files with ROS 3.4
ROV-SUP.LBR	Support utilities for ROVER12
ROVER12A.LBR	Message transfer utility for PBBS
RPASS14.LBR	Set IOBYTE/WHEEL byte running BYE5
RS-232.DQC	Modem RS-232 lines/signals defined
RSX12.ARK	Adds RSX capability to CP/M 2.2
RUN201.LBR	Run programs not normally accessible
RV2400V.UPD	Racal-Vadic 2400V modem ROM update
RXMD.ARK	File transfer using BYERSX
RZMP16.LBR	ZMODEM for RCP/M systems
SABLE.LBR	RCP/M message file displayer
SAFEBBS.LBR	Resident program hides files on RCPM
SANYCOM.COM	SANYO MBC1200/1250 terminal prog
SANYCOM.LBR	Sanyo BC1200/1250 Terminal program
SMDIALER.BQS	MBASIC Smartmodem dialer
SSTERM20.LBR	Split Screen terminal program
SURVEY.LBR	Questionnaire for new users of RCP/M
T-ROOM.LBR	Matt Wing's T-Room BBS (14 rooms)
T-ROOM2.LBR	Matt Wing's T-Room BBS (14 rooms)
T3M-HI2.ZZ0	Term3 overlay for SB180/HD64180
T3MSTPAT.LBR	Patch to T3MASTER/T3SERVER
T3S10.LBR	TERM3 tool to send text with delays
T3SNDR10.LBR	Sendout facility for TERM III
T3T-24-1.ZQ0	Telephone interface for TERM III
TABBY001.IZF	Networking/Conferencing for RCP/Ms
TBBS22.LBR	Turbo Pascal Bulletin Board pgm
TELEX.DQC	Access Telex network with computer
TINYTERM.LBR	A tiny terminal program
TKERMIT.LBR	Kermit modem program in TurboPascal
TPBBS10.ARK	Turbo Pascal Bulletin Board System
TURBOBBS.ARK	Turbo Pascal Bulletin Board System
TWIT-LOG.LBR	Track unauthorized RCP/M command use
USRCHNG.HAC	Modification to PBBS
USRMODEM.INF	Info about US Robotics Sysop deals
UUCP201.LBR	UUCP UNIX E-mail system for CP/M
UUCP20I.LBR	UNIX UUCP mail system for CP/M
VADICMOD.FIX	Improve VA3451 modem switch settings
WATSNU14.PQS	A WHATSNEW replacement in Pascal
WHATSN05.LBR	Reads XMODEM.LOG, Reports new files
WHEEL.AZM	Activate the WHEEL byte for SYSOP
WHEEL.ZZ0	Activate the WHEEL byte for SysOp
X25.LBR 	CP/M implementation of X.25 protocol
XBBSV23.ARK	A Bulletin Board System in MBASIC
XFRTOOL3.LBR	Report on KMD or XMODEM logs
XFRTOOL4.LBR	Report on KMD or XMODEM logs
XFRUPD.LBR	Update to XMODEM Log analysis
XMDM-OVL.LBR	Hardware overlays for XMDM (XMODEM)
XMDM125.LBR	XMODEM file transfer for RCP/Ms
XMSTATS.LBR	Reports statistics from XMODEM log
YMODEM8.DZC	XMODEM/YMODEM/MODEM protocol doc
ZBYE12A.LBR	BYE, as an RCP with ZCPR3
ZCMD-QX.LBR	Install ZCMD on the Epson QX-10
ZCMD29.LBR	Secure ZCPR (CCP) for RCP/M systems
ZCMD30B.LBR	Secure ZCPR (CCP) for RCP/M systems
ZCMDREN.FZX	Fix to REN problem of ZCMD
ZMD150.LBR	X/YMODEM Z80 remote file transf. pgm
ZMDOVL2.LBR	ZMD Overlays with Stand Alone mode
ZMO-1803.ZZ0	ZMP Overlay - SB180-fx
ZMO-1805.ZZ0	ZMP Overlay -- SB180-FX
ZMO-AD80.ZZ0	Overlay for ZMP14 for 80 column ADAM
ZMO-AL05.ZZ0	ZMP Overlay -- Altos 8000
ZMO-AM05.ZZ0	ZMP Overlay -- Ampro Little Board
ZMO-BB05.ZZ0	ZMP Overlay -- BigBoard II
ZMO-BW05.ZZ0	ZMP Overlay -- Bondwell 12/14
ZMO-CP05.ZZ0	ZMP Overlay -- Amstrad CPC6128
ZMO-H805.ZZ0	ZMP Overlay -- H89-H19
ZMO-HP12.ZZ0	ZMP Overlay -- HP12X
ZMO-KP11.ZZ0	ZMP Overlay -- Kaypro computers
ZMO-MD05.ZZ0	ZMP Overlay - Morrow MD3
ZMO-MH05.ZZ0	ZMP Overlay -- Morrow MD11
ZMO-MIC5.ZZ0	ZMP Overlay -- Multitech MIC-500
ZMO-OT05.ZZ0	ZMP Overlay -- Otrona Attache
ZMO-OX05.ZZ0	ZMP Overlay -- Osborne exec
ZMO-R405.ZZ0	ZMP 1.5 overlay for Tandy 4
ZMO-R415.ZZ0	Tandy TRS80 Model 4/4p ZMP15 overlay
ZMO-ROB5.ZZ0	ZMP Overlay -- DEC Robin
ZMO-SN05.ZZ0	ZMP Overlay -- Sanyo MBC
ZMO-TV05.ZZ0	ZMP Overlay -- Televideo TS80
ZMO-XE05.ZZ0	ZMP Overlay -- Xerox 820-II
ZMODEM.RQC	Modem transfer protocol discussion
ZMODEM8.DZC	ZMODEM file transfer protocol specs
ZMOH89.ZZ0	ZMP overlay for H89's
ZMP-QX01.LBR	ZMP Overlay - Epson QX-10
ZMP-XE2.ZZ0	ZMP overlay Xerox and Kaypro CP/M
ZMP15.LBR	X/Y/Zmodem file transfer program
ZMP15ADM.ARK	ZMP15 configured for Coleco ADAM
ZMP15KP.LBR	Adapts ZMP15 to video Kaypros
ZMPALTOS.MZC	ZMP Overlay - Altos computers
ZMPAMOV1.ZZ0	ZMP overlay - Ampro little board
ZMPOV3XE.MZC	Xerox/KayPro ZMP ovly, w Baud/parity

    Library 21. Modula-2 Language

2TREES.MZD	Traverse two trees simultaneously
AC-CALC.LBR	AC Calcs in TurboModula-2
ALLQ.MZD	Finds solutions of 8 queens problem
AMPROCLK.LBR	TurboModula- access to Ampro Clock
BITS.MZD	Modula-2 stuff for bit handling
BITWISE.MZD	More bit stuff for Modula-2
BOXDEMO.LBR	Demonstration of Turbo Modula-2
BS-DEFS.ARK	Modula-2 DEFS proposal from BSI
CASE.LBR	Modula-2 programming tool
CLOCKIO.LBR	Read CP/M3 & ZSDOS Clock from TM2
CODETEST.LBR	Turbo Modula-2 Absolute Address
DHRYSTON.LBR	Dhrystone benchmark in Modula-2
DICETEST.MZD	Dice rolling test in Modula-2
FDUMP.LBR	File dump utility in TurboModula-2
GRAPH1.LBR	Bar/Line/Scatter graph program
IT-TRIG.ARK	Modula-2 Trig Functions
LOG10K.MZD	Elkin's Log(10K!) in Turbo Modula-2
M2ASTRO.LBR	TurboModula-2 Astronomy Module
M2BITS.LBR	Bit stuff for Turbo Modula-2
M2BUGDEM.MZD	Demo of Modula2 bug
M2DSCLK.LBR	Full-Screen DateStamper Clock
M2DSIEVE.LBR	DateStamper timed Sieve in TM2
M2DSTIME.LBR	DateStamper access via TurboModula2
M2FST.LBR	demo stuff for Modula-2
M2GUIDE.NZT	Turbo Modula-2 User's guide review
M2NEWS.IZF	GEnie Modula-2 file listing
M2PAT.AZM	TurboModula-2 Terminal Patcher
M2PRETTY.LBR	Pretty Printer for Modula-2
M2SWCLK.LBR	SB180FX TM2 DS1216E Date/Time stuff
M2TRIG-2.LBR	Turbo Modula-2 Trig/Math Functions
M2TRMFIX.LBR	ANSI Terminal Patch for TurboModula
M2ZINIT.LBR	TurboMOdula-2 to Z3 TCAP support
MOD-2CLK.MZD	Software Clock in TurboModula-2
MODULA2.LBR	MODULA2 programs and routines
MONITOR.TZ2	Technical Note on Turbo Modula-2
MTMOD2.LBR	A selection of Modula-2 programs
OHMSLAW.LBR	Ohm's Law Calcs in TurboModula-2
OSSI100.LBR	OS definitions for Modula2
PROCON.MZD	Producer/Consumer Test module
QUEUE.LBR	Implement Queue data type in Modula2
SKY32.LBR	Star map program in Turbo Modula-2
SRCLIST.LBR	Modula-2 text lister to printer
STACK.LBR	Implement Stack data type in Modula2
TELE.LBR	TM2 graphics functions for TeleVideo
TICKTOCK.MOD	Corrected Modula-2 sample program
TM2NOT10.LBR	Notes about Modula-2
TM2RENAM.LBR	Bug-fix for Turbo Modula-2
TM2VSHM2.ARK	Compares Turbo to Hochstrasser M2
WINDOM2.LBR	Window Management in Turbo Modula 2
WNDODEMO.LBR	Window's for Turbo Modula-2

    Library 22. Product Announcements

BGII.INF	Virtual Memory/MultiTasking for CP/M
BGIIFACT.TXT	Fact sheet on Backgrounder ii
DOSDISK.INF	Info on MSDOS disk emulator for CP/M
GRUDGE.DZC	News of new Z-system computer
JETFIND.INF	JetFind -- string search utility
LI.MEX		Automatic login script for MEX-Plus
LZED.IQF	A ZCPR3 text editor
MDISK.IZF	1 Megabyte RAM disk for AMPRO
MEX16SUM.WQ	Summary of cmds in new MEX-Plus 1.65
MEXPLUS.NQW	Ron Fowler announces MEX-Plus v. 1.6
TRISYD.CAT	Latest catalog of Adam products
TSHELL.ANN	Secure remote logins for TurboDOS
ZSYSTEM.INF	Z-System information

    Library 23. Other Languages (Pilot,etc.)

ALGOL.LBR	Public Domain ALGOL compiler
APL-Z.ARK	An APL interpreter for Z80 CP/M
ASM-A86.ARK	8080->8086 cnvrsn utility in PARASOL
COBOL21.ARK	NPS Micro-COBOL compiler ver. 2.1
CPMLIB.ARK	FORTRAN-80 BDOS call enhancement
DEM2CMAL.LBR	Comal-80/Z80 demo update
DISAM86.ARK	8086 disassembler written in PARASOL
DRACO-1.ARK	DRACO - Documentation
DRACO-2.ARK	DRACO - Compiler, linker, assembler
DRACO-3.ARK	DRACO - Programs, editor, games
DRACO123.MQG	DRACO - Systems programming language
EPRO23.ARK	Small PROLOG system for Z80 CP/M
FEA.LBR 	Finite Element Analysis in FORTRAN
FRMECH.LBR	Fracture Mechanics analysis
ILISP.LBR	An implementation of LISP
ILISP.NZT	ILISP 2.0 user report of 2 bug fixes
ILISP.TXT	Description of ILISP.LBR
MOUSE.LBR	Programming language of mouse
PARASOL.ARK	Business-oriented assembler/compiler
PARASOLS.ARK	PARASOL assembler/compiler source
PILOT80.LBR	PILOT interpreter written in MBASIC
PROCON.FZX	Producer/Consumer Test Module
RATFOR.LBR	Rational preprocessor for Fortran-80
SFGR.ARK	Screen format generator for RPG II
SIL-ADD.LBR	More functions for SIL
SIL.LBR 	Subset of C programming language
SPECTRAL.LBR	Scientific applications in Fortran
STAGE2.LBR	STAGE2 -- A programming language
ZPILOT.LBR	Z80 machine language Pilot w/source

    Library 24. Pascal Language

AMORTIZE.LBR	Loan amortization in Turbo Pascal
ANAGRAM.PQS	Program for finding anagrams
ANTENNA.PZS	Find dipole antenna lengths
ASTRO.PZS	Astronomy procedures in Turbo Pascal
AUTOC23A.LBR	Auto compile control - .PAS or .MAC
BGBALPAS.LBR	Checks for balanced comment brackets
BIOCHT10.LBR	Pascal program calculates biorhythym
BITMAP2.PQS	Demonstrates boolean compression
BLIST.LBR	Lists Turbo Pascal Source Code
BORLAND.INF	Clarification of TurboPascal Status
BSORTDEM.PQS	A bubble sort demo in Pascal
BULLETTP.LBR	Screen subroutines for Turbo Pascal
CALC.LBR	A spread sheet program in Pascal
CALC224.LBR	Interactive expression evaluator
CALSGN.PQS	A Calendar/Sign program
CELLAUTO.LBR	plot Cellular Automata
CHOOSE.ARK	Helps you make decisions
CLOCK.PQS	Display analog clock on terminal
CMDTAIL.PQS	Demos use of absolute variables
COMDEMO.ARK	Turbo Pascal communications demo
COMLINE.PAS	Procedure to parse CP/M command tail
COMMENT.PQS	Boxes comments in Pascal source
CRC16.PQS	Turbo routine to calculate CRC
CROSSREF.ARK	Pascal identifiers cross-reference
DEBUG10.LBR	Debugger for Turbo Pascal programs
DIRARC2.PQS	Display directory of MSDOS ARC's
DIRTEST.PQS	A DIR program in Turbo Pascal
DLR1.LBR	Pascal & Modula-2 mortgage calc.
DUALCHK.LBR	Checks WordStar for prt cntl pairing
EASYBUFF.IQC	Turbo Pascal buffering routine
ENCRYP.PQS	Encodes and decodes a file
ENVIRON.LBR	Implement programming environment
FIXTEXT.LBR	Fix text files of orphan CR or LF
FLPTPACK.LBR	Extended Floating Point in Pascal
FNAME.LBR	Manipulation of filenames in Turbo
FRAC.PQS	Add or subtract fractions - Math
GAUSS1.PQS	Calculates area under normal curve
GENINDEX.PQS	WordStar index generator
GROUCHO.PQS	Compilable Picture of Groucho Marx
HANOI-03.PQS	Towers of Hanoi simulation
HASH.LBR	Hashing algorithm in Turbo Pascal
HIDELINE.LBR	Computer generated 3d projections
INDENT10.LBR	Formatter for Pascal source
INVENT.PQS	Turbo Pascal Inventory Management
INVENTORY.LBR	Turbo Pascal inventory program
IOPIPE.PQS	Console IO redirection routines
ISORTDEM.PQS	Insertion sort demonstration
JDATE.PQS	Converts from Gregorian to Julian
K-CHING.LBR	Book of Changes in Modula2/Pascal
LIFE.PQS	Simulation of cell life
LINEINP.LBR	Turbo Pascal formatted input module
LOG10K.PZS	Elkin's Benchmark in TurboPascal
LOTRY1.LBR	Makes list of lottery numbers
LOVE.LBR	More Pascal Frivolity
LUCIDATA.LBR	Pascal financial management programs
MAIL32.LBR	Create mailing labels
MAKEDOC.LBR	Converts text file into help screen
MAP17.LBR	Analyzes a Turbo Pascal program
MAPSTATF.LBR	Statistical analysis package
MBROT3.LBR	Mandelbrot Plots in Pascal
MEMSZ104.LBR	Turbo Pascal automatic memory sizing
MENUDEMO.LBR	Menu utilities in Turbo Pascal
METRICS.LBR	Metric Conversion in Pascal
MICROMUF.PQS	Computes min/max usable frequencies
MULTASK.PQS	Multitasking terminal program
NICEPRNT.LBR	Reformats Turbo Pascal source
NUMBASE1.LBR	Converts decimal numbers to binary
PARS.PQS	Turbo Pascal expression parser
PARSECMD.PQS	Parses the command line
PAS-ENG.LBR	Scientific applications in Pascal
PAS-SCI.ARK	TurboPascal Scientific Functions
PASCAL.TZT	Turbo Pascal function & procedures
PASCALIO.DZC	Explanation of Pascal I/O
PASCP315.LBR	Pascal-P Compiler ver. 3.1.5
PASCSCR.LBR	Turbo data entry screen generator
PASHELP.LBR	Display Turbo Editor's settings
PASMATH.LBR	Math routines in Pascal
PASMULT.LBR	TurboPascal Patch for 64180 MLT
PASPRINT.TZT	Check printer status in Pascal
PASXREF.LBR	Pascal source cross reference list
PFMT80.LBR	Formats PAS text file
PIM.LBR 	Poetry writer in Turbo Pascal
PLATO.LBR	Artificial intelligence experiment
PLISTCPM.PQS	Pretty print program in Pascal
PLOTTER.LBR	Plotter routines for PascalP
PM.LBR		Pascal source formatter
PMLINK.LBR	Use M80 routines in Turbo Pascal
PORTMNIO.PZS	I/O port monitor
PP319DOC.LBR	Documentation for Pascal-P
PP319FIX.LBR	Fix to Pascal-P v 3.1.9
PP319UPD.LBR	PASCAL-P Compiler version 3.1.9
PPMANUAL.PZN	Documentation file for Pascal-P
PPRINT.LBR	Pretty printer for Turbo Pascal
PRETTY2.PQS	Formats Pascal source files
PRINT.PAS	simple routine to print a file
PROFILER.LBR	Execution time profiler for Pascal-P
PRTPROC3.LBR	List procedures, functions, of Turbo
PS.LBR		Pascal screen program writer
QQSORT.LBR	Example of quick sort in Pascal
RANDNUMB.PQS	Random number generator for Pascal
RECIPE.PQS	Recipe database system in Pascal
REFSORT.LBR	Sort references longer than a line
RNF-PAS.LBR	ROFF/TROFF/RUNOFF-like word proc.
RUN.PQS 	Allows chain to another Turbo pgm
SET3.PQS	Smith-Corona printer setup program
SIMP52.LBR	Simplified Integrated Modular Prose
SOFTCLK2.LBR	Full-screen Software Clock
SORTDIR.PQS	Turbo routine to read/sort directory
SPLINE2.PQS	Interpolating between data points
SPLIT-IT.LBR	Splits large files
SQZTURBO.LBR	Turbo routines for squeeze/unsqueeze
SSORTDEM.PQS	A selection demo program in Pascal
STRINGS.LBR	String operations in Pascal
STUMP.LBR	Four benchmark programs in Turbo
TAB2SPC2.LBR	Replaces TABs in text files
TAN.PQS 	Tangent function for Turbo Pascal
TAUSGEN3.PQS	Tausworthe Pseudorandom nr generator
TBDEMO.PQS	Turbo-Access demonstration pgm
TESTBDOS.PQS	Shows use of BDOS function in Turbo
TEXTUTIL.LBR	Turbo programs work with text files
THESEUS.LBR	Turbo-Pascal MAZE program
TINYPAS4.LBR	Pascal compiler for the H8/H89
TLOAD.LBR	Link assembler routines in Turbo
TOWERS.PQS	Towers of Hanoi simulation
TP-LA1.LBR	Loan amortization program
TP-UTIL.ARK	Source from Complete Turbo Pascal
TP/UTI2.LBR	Collection of Turbo Pascal programs
TP/UTI3.LBR	Collection of Turbo Pascal programs
TPBANNER.LBR	Print banners with Turbo Pascal
TPFIX12.PQS	Patch to avoid warm boots
TPIO22.LBR	Control console data entry
TPMAP.LBR	Turbo Pascal screen mapper
TPUNCR.LBR	Use crunched files in Turbo Pascal
TPWARMST.PZT	Exit Turbo program without warmstart
TRANSFOR.PZS	Transformation of data in Turbo
TRAVESTY.LBR	A TRAVESTY generator in Turbo
TRBXREF.LBR	Turbo Pascal cross reference program
TRIG.PAS	Trig extensions to Turbo Pascal
TRUN.LBR	Turbo Pascal shell to run CHN files
TTUTOR1.LBR	Turbo Pascal Tutorial - Part 1
TTUTOR2.LBR	Turbo Pascal Tutorial - Part 2
TURAMORT.LBR	Amortization program in Turbo Pascal
TURBFIX.PQS	Capitalizes reserved words in Pascal
TURBLOAD.LBR	Include assembler routines in Pascal
TURBO.FQX	Discusses problems with Turbo COMs
TURBOBAS.RQF	Turbo Pascal <--> MBASIC equivalents
TURBOFIX.LBR	Fixes console input system of Turbo
TURBOINS.LBR	GP install util. Turbo .COM files
TURBOIO.LBR	I/O routines in Turbo Pascal
TURBOP.LBR	Fix Turbo Pascal to run on Bondwell2
TURBOPAT.LBR	Patches to Turbo's message file
TURBOPWR.PQS	A Power function for Turbo
TURBSCR.LBR	Turbo data entry screen generator
TURBSCR2.LBR	Turbo Pascal screen generator
TURBWIN3.LBR	Window procedure for Turbo Pascal
TXREF-11.PQS	Pascal source cross reference list
TYPEX.PZS	Turbo lister and cross-reference
USINGTP.ARK	Source code from the book Using Turb
USQ141.LBR	Turbo Pascal UnSQueezer
VIDEO.INC	Turbo Pascal include for C128 CP/M
VT100.PQS	VT100 terminal emulator, TurboPascal
WHATDAY.LBR	Find the day of week in Pascal
WILDCARD.LBR	TurboPascal procedure-CP/M filenames
WINDOMAN.LBR	Simulates windows in Turbo Pascal
WINDOW11.LBR	ASCII windows for Turbo Pascal pgms
XLIST62.LBR	Cross-reference listing for Pascal
XREF.PQS	Pascal source cross reference list
ZFIND5.PQS	Find string, ignores UPcase, HiBit
ZINDENT7.LBR	Pascal pgm to format dBASE/Pascal.
ZXREF.LBR	dBASE & Turbo Pascal cross reference

    Library 25. Printer Utilities

BARCODE.LBR	Print 3 of 9 barcode on Epson LX80
BFUPDAT1.LBR	Bradford 2.02 - uses less memory
BRAD-GRK.LBR	Greek font for Bradford
BRAD-HEB.LBR	Hebrew font for Bradford
BRAD-WS.TQP	Bradford tip for WordStar dot cmds
BRAD2-A.ARK	NLQ & lotsa fonts for Epson, Gemini
BRAD2-B.ARK	Lots more fonts; use with BRAD2-A
BRADCON.LBR	Font creation for Bradford
BRADFIX.PAT	An update for BRADFORD
BRADFONT.LBR	Disassemble Bradford font files
BRADFORD.LBR	Near letter qual. on dot matrix ptr.
BRADFORD.MQG	Bradford command summary
BRADLIST.0Z1	List of BRADFORD supporting software
BRADZEX.LBR	Using ZEX to control Bradford
BRFONTS.LBR	Fonts for Bradford printing program
CASLABEL.LBR	Print cassette tape (& other) labels
CHRS.LBR	Generalized printer setup utility
CITOH.LBR	Preset C-ITOH M-1550 options.
CPMPDSW.LBR	CP/M sideways print for spreadsheets
DBL401.LBR	Print two pages side-by-side
DECSET.LBR	DEC LA-120 printer setup program
DIABL630.LBR	Custom print wheel install-Diablo630
DRAW140.LBR	Plotter routines for Diablo 630
DRAW630.LBR	Turbo Pascal plotting subroutines
EDFONT.LBR	Full screen editor to create fonts
EP-ADDS.ARK	Additional fonts for Epson Print pgm
EP-COMS.ARK	Epson Print formatter executables
EP-DOCS.ARK	Documentation for Epson Print
EP-ECHED.ARK	Font editor for Epson Print
EP-FONTS.ARK	Fonts used with Epson Print
EP-INFO.ARK	Info file of Epson Printer formatter
EP-MISC.ARK	Files needed to compile Epson Print
EP-SRC.ARK	BDS-C source for Epson Print
EPSETUP.LBR	Epson MX/RX/FX80 printer setup
EPSON.COM	EPSON.PAS file compiled
EPSON.PAS	Epson RX/FX80 printer setup program
EPUP.LBR	Send control codes to Epson FX-80
EXTRAFON.LBR	Additional fonts for Bradford print
FACELIFT.BQS	Select typeface-Epson RX/FX/MX ptrs.
FANFX3.LBR	Print text on both sides of fanfold
FASTMX80.MOD	Speed up the Epson MX-80 printer
FFF.LBR 	Fancy Font Filter
FFORMS.LBR	Print data files on special forms
FIVLNLBL.LBR	Prints a five line label
FONTSET1.LBR	Downloadable fonts for Epson FX
FONTSY.LBR	Multiple font banner printer
FX80-Q.LBR	Utilities for Epson Fx80 printer
FX80PTPR.LBR	Epson FX-80 print option setter
FXCHAR.LBR	Epson FX printer char. set generator
FXPARMS.BZS	Epson FX-80 type styles illustration
FXPRINT.ARK	Epson FX-80 printer setup pgm.
GCSFX.LBR	Epson FX-85 setup/print/typewriter
GEEFONT4.LBR	Fonts with MAKEFONT compiler
GEMPRINT.LBR	Sets up the Gemini 10x printer
GFONTS.LBR	Fonts for GEEFONT
GFSRC.LBR	Source for fonts in GFONTS.LBR
GOTHIC.LBR	Gothic-style characters on printer
GSET.LBR	Star Micronics printer setup utility
GSIGNS32.ARK	Turbo Pascal files for SIGNS
HB15-PT1.ARK	Hershey fonts banner printer - part1
HB15-PT2.ARK	Hershey fonts banner printer - part2
HIGKFONT.LBR	Greek character set for Epson Fx
IMAGEPRT.LBR	Fantastic print program for Epson
ITAL-OKI.LBR	Italics character set for Okidata
KFONT389.LBR	The COMPLEAT KwikFont.
LBLMKR4.LBR	Prints mailing lists on labels
LISTT16.LBR	Paginated file lister with options
MACPRINT.LBR	A fancy printing program for Epson
MSIGNS12.ARK	Pascal MT+ SIGNS for 8080 systems
MX80PRNT.AQM	Epson MX printer setup program
ND110.LBR	ND textfile printer dumping utility
NECSET.AQM	Sets NEC-8023A-C printer parameters
NLQ.LBR 	NLQ on bit image graphics printer
NOBS.ARK	Underline w/non-backspacing printers
OKI2-INS.LBR	OKI 82/93 printer setup utility
PDSW.LBR	Print text sideways
PR2-PR3.LBR	Epson/Gemini printer utility
PRINT120.LBR	Gives WordStar control over printers
PRINT24A.LBR	A file printing utility
PRINTCPM.LBR	Several printer setup utilities
PRINTSET.LBR	General printer set up utility
PRN24PCH.LBR	Patches for PRINT24A program.
PRNTCHAR.LBR	Printer setup using text files
PSET17.LBR	Preset Epson/Citizen printer states
QLIST15.LBR	Paginated lister for SQueezed text
QWIKFONT.LBR	Generalized printer set up
SEND.LBR	Sends string to LST: device
SET192V3.AQM	OKI 192/193 setup utility
SETMRG20.LBR	Set left/right margins for Diablo
SETPRINT.LBR	Setup printer for special features
SIDEMT4.LBR	List file sideways on printer
SIDEWAY2.LBR	Print text sideways on Epson printer
SIDEWYS4.LBR	Print sideways on printer
SIGNS.DQC	Documentation for SIGNS
SIGNS.MQG	Message about the SIGNS package
SLMT.LBR	Set margins on daisywheel printers
SWAP.ASM	Swaps console and list device output
SWITCHIO.LBR	Changes I/O byte assignments
TEX.LBR 	TeX computerized typesetting program
TLIST12.LBR	Fortran-80 & Turbo Pascal pgm lister
TSIGNS41.ARK	Turbo Pascal support files for SIGNS
TYPRINT3.LBR	Use printer as a typewriter
VPRINT.LBR	Vertical Printing Program
WALLPAP3.LBR	Prints interesting patterns in Turbo
WALLPEP3.LBR	Print patterns on Epson printers

    Library 26. RCP/M Lists,Phone Lists,Other

ASTROBBS.LZT	List of astronomy related BBS's
DBBBS20.LBR	dBASE database system for BBS number
FEDBBS.LST	Federal sponsored bulletin boards
FINDRCPM.LBR	Selects subset of RCPMxxx.LST
FUBBS88.AZG	Phone numbers of all known BBS's
FUBBSX.BQS	Extracts phone numbers from FUBBS
HAMBBS12.LZT	Ham Radio BBS phone number list
MED0489.LZT	List of Medical related BB systems
MED1088.ARK	List of medical related BB systems
MEDBBS.TZT	List of medical bulletin boards
NEW-SYS.OZS	Get your RCP/M on monthly list
RCPM0989.BZF	Concise list of RCP/M systems
RCPM0989.LZT	List of Remote CP/M systems
RCPMSCAN.LBR	Scan for strings in monthy RCPM list
SCANLST2.LBR	Extracts from the RCPM-nnn lists
SETMRG21.LBR	Set margins on Diablo printers
THLST102.LBR	List of Atlanta Bulletin Boards

    Library 27. Reviews,Hardware & Software

1200$87.MDM	Review of Avatex $87 300/1200 modem
BONDWEL2.MQR	More info about the Bondwell-2
BONDWEL2.RQV	Bondwell 2 laptop computer review
DMANAGER.RQW	Review of dMANAGER, a dBASE tool
DUCK-MDM.RZV	Review of ADC Duck modem
HANDYMAN.IQF	Review of 'Handyman' (like Sidekick)
HAPFONTS.LBR	Font printing program
KUGEL.DZC	Review of BackGrounder ii
MEGACOPY.REV	Review of Adam cassette copy program
NO-SLOTS.RZV	Review of two real time clocks
PRESTO.RZV	Review of PRESTO! for Kaypros
RUNCPM.IQF	Run CP/M on IBM-PC at up to 10 MHz!
USR9600.TQT	Info on Courier HST 9600 bps modem
WS4REVU2.TXT	WS4 - it's great - worth the update!
WS4REVUE.TXT	WordStar 4 - is it really improved?
WSBOOKS.AZT	Review of two books on WordStar

    Library 28. SIG/M Users Group Disks

CPMUG012.ARK	CPMUG distribution disk #012
CPMUG081.ARK	CPMUG distribution disk #081
CPMUGCAT.ARK	CPMUG users group disks catalog
FYNDE.COM	Search SIG/M.CQT for specified file
S182-294.CZT	SIG/M catalog of volumes 182-294
S295-303.ARK	SIG/M catalog of volumes 295-303
S304-310.ARK	SIG/M catalog of volumes 304-310
SIG0.CZT	SIG/M Catalog - Volumes 151-294
SIG1.CZT	SIG/M Catalog - Volumes 1-150
SIGMBAS.LZT	BASIC files in SIG/M v1-256
SIGMDISK.LZT	SIG/M catalog compacted
SIGMFEXT.LZT	SIG/M file list sorted by .EXT
SIGMFILE.LZT	SIG/M file list sorted by name

    Library 29. Compression Utilities

ARK10.ARK	Version 1.0 file ARKiver
ARK11.ARK	Fixed ARK (sgh)
COMPRESS.ARK	12-bit LZW 'compress' for CP/M
CPMSQV3.LBR	SQueeze/UnSQueeze - Turbo Pascal
CRN24PAT.AZM	Patch to CRUNCH 2.4 for AZM files
CRNCH23D.LBR	CRUNCH/UNCR for DateStamper
CRNCH24S.LBR	Source for Cruncher/Uncruncher
CRUNCH.IZF	Specs for CRUNCHed header record
CRUNCH24.LBR	LZW data compression utilities
FCRNCH11.COM	Uncruncher for 8080/8085 systems
FCRNCH11.LBR	CRUNCHer for Z80, 8080, 8085, V20
FREEZE.LBR	standard of LZHUF technique for CPM
LH-CPM11.LBR	Uncompression utility for LHARC file
LHCPMSRC.LBR	C source for LZH extractor/lister
LT28.ARK	File typer/extractor/decompressor
LZHUFCPM.LBR	LZHUF file compression for CP/M
LZW.DZC 	Documentation from LZW.LBR (1399)
LZW.LBR 	Compression/decompression Utilities
SPLAY.ARC	SPLAY Trees data compression method
SQ.PQS		File SQueezer
SQ111.LBR	Machine language SQueezer -- fast
SQUEEZE.TXT	Tutorial on SQueeze/UnSQueeze
SQUPRT33.ARK	Portable SQueeze/UnSQueeze in 'C'
TYPELZ22.LBR	Types ASCII, Q, Z, LBR files
TYPEQZ17.LBR	TYPE utility with wildcard filenames
TZINST15.DZC	Install instructions for TYPELZ v15+
UF.LBR		Fast unsqueezer for Z80 computers
UNCR24.COM	Uncruncher for Z80 processors
UNCR8080.LBR	UNCRunch for the 8080/8085
UNSITCPM.ARK	UNSIT utility for CP/M
UNSQ-CR.LBR	REL files for Uncruncher/Unsqueezer
USQ120.COM	Unsqueezer for all CP/M systems
USQ120.DOC	Documentation for Dave Rand's USQ120
USQFST20.LBR	Fast unsqueezer for Z80 computers
UUECPM.ARK	CP/M vers. of Unix UUENCODE/UUDECODE

    Library 30. Spreadsheets

AMORTAB6.LBR	Loan amortization with SuperCalc
ARCS-DEP.CZL	Calculate depreciation in Super Calc
CHALK21.ARK	Electronic Spreadsheet for CP/M-80
EXTRCAL1.ARK	SuperCalc spreadsheet add-on
LONAMOR.LBR	SuperCalc loan amortization template
MONYFUND.LBR	Calcstar Portfolio Review
PCTAX88.LBR	Perfect Calc template for 1988 taxes
PRFCLCUT.LBR	Utilities for Perfect Calc
PRFTCALC.LBR	Utilities for Perfect Calc
PVFVAN10.LBR	SUPERCALC templ. value on investment
QSOLVE11.LBR	A spread sheet for CP/M.
RULE-78.CZL	Rule of 78 template - Super Calc

    Library 31. System Utilities/Submit

16/8-MOD.DZC	Xerox mod to generalize RAM support
22DBLOCK.DOC	DR patch for CP/M 2.2 BDOS
22RSX/20.ARK	Adds RSX capability to CP/M 2.2
822RIGID.LBR	Add rigid drive to Xerox 820-II
89MENU22.ARK	Menu program for the Heath 89
950FUNC.AQM	Loads function keys for Televideo
ADM3-150.AQM	ADM3 emulator for Hazeltine 1500
AKA13.LBR	Passes multiple commands to CP/M
AUTOBOOT.LBR	Autoboot a command at start up
BDLOC.AQM	Displays start of CCP and BDOS
BG2-LIST.LZT	List of all BackGrounder software
BG2WYSE.LBR	Wyse terminal driver for BG-II
BGECP.LBR	BackGrounder ECP loader
BGH19SCR.LBR	HEATH-19 screen driver source for BG
BGHIST04.LBR	BGii History Shell w/ZEX fix
BGIIDEM3.LBR	Demo version of super OS enhancement
BGIIDRV.LBR	drivers for BackGrounder ii
BGMEMTST.AQM	Continuous memory test in background
BGQWKSWP.INF	Hints for speedy BG ii swapping
BIGTPA.ARK	Uses bank 0 to increase TPA size
BIOSCLK.LBR	Sets BIOS clock for Ampro
BUILDSUB.BAS	Chain from Basic to another .COM pgm
BW2UTIL1.LBR	Utilities for the Bondwell 2 laptop
CCT2.LBR	Multi-purpose file handler
CHEK15.LBR	Calculates CRC value for files
CITCRC11.LBR	CRC check using CCITT polynomial
CLOCK.LBR	Realtime resident s/w clock for OSB1
CMDLN11A.LBR	Execute program when system boots
CNKYPM10.AZM	PoorMan's Network/Columbia Shoebox
COM-MENU.LBR	Simple menu system for COM files
COMID1.LBR	Identifies if COM file is CP/M/MSDOS
CONIX.LBR	Extension to CP/M operating system
COP12.LBR	Console filter for blind CP/M users
CPM22APP.LBR	Application notes for CP/M 2.2
CPM22PAT.LBR	Patches to CP/M utilities from DRI
CPMDATE.LBR	Display and set date for Z80DOS
CPMPATS6.TZT	Patches to CP/M and DRI utilities
CPUDIAG.LBR	Extensive diagnostic for 8080/8085
CPUTEST.LBR	Identify which CPU chip is in system
CRCK44.LBR	Calculates CRC value for files
CRCKK33.LBR	Calculates 16-bit CRC of a file
CRT-TEST.AQM	A Barber pole CRT terminal test
CSWEEP21.LBR	Command line SWEEP-like utility
DDTPORT.LBR	Screen-oriented I/O port debugger
DF.LBR		Displays remaining disk space
DIFCOM16.LBR	File comparison utility
DOALL.LBR	Utility for the Epson PX-8
DOSLIKE.LBR	Five MS-DOS like utilities
DOSPLS25.ARK	Enhanced replacement for CP/M 2.2
DOSPLSOR.ARK	Source code for DOSPLS25.ARK
DSKDRV16.LBR	Allows read/write of foreign disks
DSTAT10.LBR	Displays info of disk control blocks
DVRPATCH.AQM	Temporary alternate console driver
DYNATEST.AZM	Dynabyte Memory Test
ECHO3.LBR	Disables console output for batch
EDIR.LBR	Recover files accidentally erased
EDXE.LBR	EDFILE modified for the Xerox 820
EGUTIL53.LBR	Eric Gans great CP/M utilities
ENSPOL10.LBR	Captures all LST device output
EX15.LBR	Memory-based submit, very fast
EXTIME89.LBR	Osborne Executive clock setting util
EZ10.LBR	Autoload preselected COM w/argument
EZALIAS3.LBR	Construct alias files for EZCPR
EZCPR-KP.LBR	This is my EZCPR set for Kaypros.
EZCPR.LBR	Ready-to-run ZCPR subset.
FIFOS.MZC	Example for adding interrupts to I/O
FMT20.LBR	Osborne 1 DD format/sysgen/findbad
FNK-KBD.LBR	Source for FNKEYS21 and KEYBD20
FNKEYS2X.LBR	Changes function keys on Osborne
FRONT51.ARK	Cursor-oriented command menu utility
FUNKY12.LBR	Program terminal function keys
GKEY2.LBR	Keyboard re-definer, uses only 3k
GKX390.LBR	Keyboard enhancement program
GO108.LBR	Move easily around drives/user areas
GSUB20.LBR	Super SUBMIT replacement
HDINFO.LBR	Show AMPRO hard disk buffer address
HDS101.LBR	Select two hard disks on Ampro
HEXDIF2.LBR	Prints HEX diff. between two files
HIST197.AZT	Author's article/info on HIST197
HIST197.LBR	Recall last 9 CP/M command lines
HOLD10.LBR	Program waits till time elapsed
I/O-CAP.LBR	Capture console I/O to disk
I/O-MAP.AQM	Lists map of all system I/O ports
IFSKIP21.LBR	IF and SKIP processor for SUBMIT
INTRTRAN.LBR	Computer-to-computer file transfer
INUSE-11.LBR	Display that your system is in use
IOCAPKP.LBR	Captures console output for print
JOB15.LBR	Enhanced SUBMIT replacement
KEYBD20.LBR	Redefines Osborne Executive keyboard
KEYCHK20.AZM	Keyboard checker/tester w/8-bit
KPTRCLK.LBR	Caption for TurboRom time display
LOCK10.LBR	CP/M file locker for security
LOG10.LBR	Log in drive and user, ZCPR style
LOGON12.LBR	Command line menu/password utility
LSTPATCH.AQM	Patch CP/M for temporary list driver
MAGIKEY.ARK	Key reassignment utility
MAKESUB2.AQM	Chain from one program to another
MAKSRL.LBR	Creates a self-relocating program
MBDOS.LBR	Protect a buffer below the BDOS
MDCLCK13.LBR	Info to install clock for Morrow MD
MEM-MAP.AQM	Lists complete map of system memory
MEMCOM.LBR	Set up a RAM disk using TPA space
MEMDIAG.LBR	Memory diagnostic utility
MEMTST11.AZM	Memory diagnostic utility
MKBATCH2.LBR	Batch file utility multiple commands
MKLINE.LBR	Inserts file names in submit files
MPX.LBR 	CP/M operating system replacement
MSWEEP.LBR	Copy file to/from 8 in. CP/M & MSDOS
MSXRT3.LBR	Info on the Intersil ICM7170 clock
NCRCK1.LBR	File CRC error-checking program
NEWBAT3.LBR	Makes SUBMIT-like batch COM files
NEWBATCH.LBR	Make SUBMIT-like COM files
NEWKEYS.LBR	Xerox 820 key redefinition program
NOSLT20.LBR	Read and set no-slot clock
NOSLTDOS.LBR	No-slot clock for file date stamping
NOVADOSH.LBR	Replacement for CP/M BDOS
NSWP207.COM	Updated 11k file and disk manager
NSWP207.DQC	Documentation for NSWP207.COM
NSWP207.LBR	Disk/File maintenance utility
NSWPHINT.TQT	Hints on more effective use of NSWP
NSWPTIPS.0Q1	Helpful hints on using NSWP207
NSZTIME.LBR	Add Ztime clock to NorthStar
OCP145C.LBR	OCP for BackGrounder ii (Prelim.)
OFFCTRLC.LBR	Disable control C break
OFFRUN34.LBR	Autoloads command on system startup
OXTPATCH.ARK	Osborne Executive interrupt bug fix
P2DOS23.LBR	Enhanced CP/M 2.2 BDOS replacement
PASS11.LBR	System startup password protection
PASSIT10.LBR	Aliasing utility chains another cmd
PASSWD30.AQM	Adds password protection to COM file
PASSWORD.BAS	Adds password protection to COM file
PATCH&GO.LBR	Patches and runs a program in memory
PATCKY11.LBR	Modify function keys for Sanyo
PAUSWAIT.AQM	Allows Pause or Wait in Submit files
PEEKCPM.LBR	Memory examine and modify/PEEK-POKE
PMO-SB10.ZZ0	Poor Man's Network driver - SB180
PORTCHK.LBR	Displays data present at a port
PROBE102.LBR	Display address of CCP, BDOS, & BIOS
PROMFORM.LBR	Prepare ROMS for Epson Geneva PX-8
PUBPAT11.LBR	Add Public files to CP/M 2.2
PXBIOS.AZM	Epson Geneva BIOS routine addresses
PXINTRPT.DZC	Handling interrupts on Epson Geneva
PXSCREEN.AZM	Screen definitions for Epson Geneva
QK21.LBR	QuickKey - a pd SmartKey for CP/M
QKSHOW.LBR	Examine values of QwikKey file
RAMFIX.LBR	Fix for RAM disk on SB180
RAMMAP.LBR	Displays key CP/M locations.
RAP.LBR 	Directs printer output to disk file
RDCLOCK.LBR	Read clock and save to a file
REDIR31.LBR	I/O redirection utility
RELCPM.LBR	Integrate BIOS into MOVCPM
RELDUMP.AQM	A dump program for REL files
RFSHTEST.MZC	Dynamic memory refresh test
ROMMOV.LBR	Copies Morrow driver ROM to file
RSX2.LBR	Add system calls to CP/M 2.2 system
RSXMAKER.LBR	RSX maker for CP/M 2.2
RTX141.LBR	Easier use of Epson PX-8 facilities
RTX142.LBR	Funtion key redefinition for Geneva
SAFRAM5.LBR	Creates a safe zone below the Bdos
SAFRAM6.LBR	Creates a safe zone below the BDOS
SAVBIOS.LBR	Save new BIOS for Montezuma Micro
SCSIBOOT.LBR	Hooks for SCSI/PLUS bus interface
SETDRU13.LBR	Drive/user search path for overlays
SETIO.AQM	Sets and views the CP/M I/O byte
SLTRAP.LBR	Trap console/printer output to file
SS1TIME.AQM	CompuPro System Support 1 time rtns
SSTAT18X.LBR	Video-oriented replacement for STAT.
SUBTOOL.LBR	Pauses/Delete files in SUB procedure
SUPRDOS2.LBR	Complete CP/M 2.2 BDOS replacement
SUPRMIT3.LBR	Enhanced SUBMIT command processor
SUPSUB13.LBR	A super SUBMIT replacement, v1.3
SURVEY3.AQM	Survey memory, ports, disk space
SWTIME.LBR	Software for SmartWatch
SYN.LBR 	Makes a file out of command line
SYNONYM3.LBR	Allows two names for a CP/M command
SYSTEM.LBR	Jump to any memory location
TELL02.LBR	Displays addresses of BDOS and BIOS
TIMTEST.LBR	Memory diagnostic utility
TPA10.LBR	Shows TPA size in bytes and K
TPA32.LBR	Report/change TPA memory available
TRANTOR.LBR	Trantor/WestWind hard disk new CCP
U3.LBR		Changes drive/user, ZCPR style
UMPIRE.LBR	Comprehensive memory test diagnostic
UNMDISK.LBR	Remove resident programs from memory
UNSPOL42.LBR	Background printer spooler
USER13.LBR	Northstar Advantage function keys
WORM21.AZM	Memory diagnostic utility
XCCP.LBR	Extended command CCP replacement
XDRIVE10.LBR	Extra memory to be used as disk
XOUT.LBR	Allows removal of XtraKey
XUSER11.LBR	Extended USER command
XWP11.LBR	Integrated software for Osborne
XWP11SRC.LBR	C source for the Executive Workplace
YKEY21.LBR	Set function keys in specific pgms.
Z2FILER.LBR	Video filer disk utility
Z80CCP.ARK	Z80 CCP replacement - Enhanced CCP
Z80D-FIX.LBR	BIOS insert for Z80DOS with no RTC
Z80D20A.LBR	Z80 replacement for CP/M 2.2 BDOS
Z80D24SR.LBR	Source files for Z80DOS
Z80DMOD.LBR	Z80DOS mod for imbedded date routine
Z80DOVL.LBR	Program overlays to support Z80DOS
Z80DS231.LBR	CP/M BDOS replacement for Z80
ZCMD8080.LBR	CCP replacement for 8080 systems
ZCPR-BW2.LBR	ZCPR Version 1 for the Bondwell 2

    Library 32. TurboDos

ALLDIR.COM	Display directory - all users
ALLDIR.DOC	Documentation for ALLDIR.COM
ALLDIR11.LBR	Display directory - all users
ATTREM.A	Remote attach - 16-bit TurboDOS
ATTREM.CMD	Remote attach - 16-bit TurboDOS
ATTREM.COM	Remote attach - 8-bit TurboDOS
ATTREM.MAC	Remote attach - 8-bit TurboDOS
BINDEC.A	Binary to decimal conversion
BREAKO.MAC	Break apart 16 bit .O files
CBTOD.AQM	CB80 2.0 time/date replacement modul
CHECKDIR.LBR	TurboDOS Vers. 1.4+, Check directory
DCHECK.COM	TurboDOS directory integrity check
DCHECK.DOC	TurboDOS directory integrity check
DCHECK.MQC	TurboDOS directory integrity check
DELALL.MQC	TurboDOS multiple file delete
DIRPAT17.LBR	DIRectory PATch utility for TurboDOS
DIRPAT3.COM	8-bit TurboDOS directory patch util.
DIRPAT3.MQC	8-bit TurboDOS directory patch util.
DISK12.LBR	TurboDOS disk/directory file editor
DPINST.COM	DIRPAT install program
DPINST.MQC	DIRPAT install program source
DSKRAM.A	Source for 16-bit TurboDOS Ramdisk
DSKRAM.DOC	16-bit TurboDOS Ramdisk information
FANLED13.LBR	TurboDOS fancy command line editor
LU310-TD.CQM	Library Utility patched for TurboDOS
LUFIX.TD	Fix to run LU under TurboDOS
LUX53-TD.LBR	LUX for TurboDOS
MDRV-TD.LBR	TurboDOS driver for CompuPro
NSWPT.LBR	NSWP for TurboDOS
NSWPT26.LBR	New Sweep for TurboDOS
PDIR10.LBR	Display TurboDOS directory like CP/M
QDIR.LBR	TurboDOS 1.4 Quick DIRectory list
TD-FREE.LBR	Shows free space of disk in TurboDOS
TUG.INF 	Address of TurboDOS Users' Group

    Library 33. ZCPR3/SYSLIB & ZCPR1

-NZCOM.DZC	News about NZCOM... ready to ship
@10.LBR 	Control screen output in ZCPR3
ACOPY22.LBR	General purpose Z80 file copy
ACREATE3.LBR	Creates a ZCPR3 ALIAS file
ADIR24.LBR	Alias DIRectory utility
ADIR25.LBR	Sorted aliases list in DIR format
AFIND13.LBR	Searches the directory for aliases
ALIAS#1.LBR	Many new ZCPR3 utilities
ALIAS#2.LBR	New Alias scripts for Z-System
ALIAS11.LBR	Script expansion utility of ZCPR3
ALPHA.INF	Alpha Systems has acquired Z-system
ARKDATZD.ARK	ZSDOS DateStamping for ARK04
ARNZ09N1.LBR	ZCPR33 extended command processor
ARUNZ09Q.LBR	latest version of ARUNZ
AS-0628.NZW	Information from Alpha Systems
AUTOZINS.CCP	Install ZCPR3 utilities with CCP MOD
BALIAS13.LBR	Replacement for ZCPR3 ALIAS
BANKSYS1.LBR	More on bank switched systems
BCOMP13.LBR	Binary file comparison utility
BEDITOR.LBR	Editor and screen code from ZPATCH
BGQUICK.LBR	Ease loading of BackGrounder w/ZCPR3
BGSCRIP1.DZC	Hints-using BackGrounderII w/ZCPR3
BU-ARCH.DZC	Aliases for hard disk backup
BUSHBETB.LBR	ZCPR3 Harddisk Backup utility
BUSHFIX1.LBR	Correct COM file for BUSHBETB
C-HELP.LBR	Collection of HELP files for ZCPR33
CALCBSX.LBR	ZCPR resident command calculator
CALRCP11.LBR	ZCPR3 Resident Command calculator
CD34B.LBR	Log into dirrectory by name or DU
CLEAND18.LBR	Sorts/packs/cleans ZCPR33 directory
CMD13.LBR	Define/run command line in ZCPR3
CMDRUN10.LBR	ZCPR3 command run demo program
COMIF10.LBR	IF testing for submit under ZCPR
COMMEN20.LBR	ZCPR3 mini-chat utility
COMP28.LBR	Compare files, display differences
CONCAT03.LBR	Concatenate two or more files
CORREC10.LBR	Use CORRECT-IT with ZCPR3 user areas
CPA12.LBR	Compare and analyze two text files
CPSEL10.LBR	ZCPR3 CRT/PRINTER selection tool
CPSET11.LBR	Define console/printer features
CR24OZ8D.LBR	Z80DOS date stamp for CRUNCH24/UNCR
CRC22.LBR	ZCPR3 CRC file checking tool
CVIDLIB.LBR	Video routines for C with ZCPR3
D12.LBR 	Directory utility for Z80
D15.LBR 	ZCPR3 directory display utility
DBRCPREL.LBR	ZCPR3 debug RCP using SEGLINK
DEBUGRCP.AQM	ZCPR3 resident debug command package
DEV11A.LBR	Command driven ZCPR3 IOP control
DIFF30.LBR	Compares two files, displays results
DIR14.LBR	ZCPR3 directory program
DIRATR12.LBR	Displays file attributes
DOSVER03.LBR	DOS version utility for ZCPR3
DOSZ8ZRL.LBR	Loads Z80DOS with NZCOM standard
DOW002.LBR	Print day of week with ZSLIB/SYSLIB
DPGFILE.LBR	Files for ZCPR3 DPROG interpreter
DPROG12.LBR	Peripheral device control for ZCPR3
DSCRESV1.LBR	Save DateStamper date when editing
DSKNDR11.LBR	ZCPR3 named directory tool
DSLBR.LBR	Library maintenance utilities for Z3
DT42BUGS.MZG	Problems with the DT42 systems
DU314A.LBR	ZCPR3 disk maintenance utility
DUMP12.LBR	Dumps files in hex and ASCII
EASE20.LBR	ZCPR 3.3 command line editor
EASE20.QZF	Quick reference card for EASE
EASE20T.LBR	Overlay for EASE20 displays time
ECHO10.LBR	Sends tail to CON: or LST:, for ZCPR
EDITND.LBR	Edit the system named directory
EHOFF.ZZ0	Shuts off ZCPR 3.3 error handlers
ERASE52.LBR	ZCPR utility to erase files
ERAZ14.LBR	Z80 Erase utility
ERRATA1.Z33	Assembling the Z33 FCP and RCP
ERROR110.LBR	Elaborate ZCPR3 error handler
ERROR210.LBR	CRT-oriented ZCPR3 error handler
ERROR310.LBR	Simple ZCPR3 error handler
ERROR410.LBR	Very simple ZCPR3 error handler
ERRORX11.LBR	Cancels ZCPR33 error handling
ERRSET13.LBR	Displays/clears/sets error handler
ERRUTILS.LBR	Error handling routines for ZCPR33
EXTCMDRN.DOC	Extended ZCPR3 CMDRUN via alias
FAST-180.MSG	CPU speed upgrade for SB-180
FASTARNZ.ZZZ	Optimizing automatic disk accesses
FF19.LBR	FileFind for Z-Systems
FINDF26A.LBR	ZCPR3 utility finds file on any disk
FINRP28Z.LBR	Find/Replace utility for ZCPR
FMANG12.LBR	ZCPR3 Menu-oriented cmd preprocessor
FNDERR14.LBR	Compiler/Assembler automation for Z3
FNREPZPT.LBR	Adapts FINREP24 to ZCPR3
FOR-NXT2.LBR	Perform command repeatedly
FOR-SUPP.LBR	Z-system FOR and K-FOR
GETVAR12.LBR	Define and refer to shell variables
GOTO13.LBR	ZCPR3 branching tool for ZEX
HD-ARC13.LBR	ZCPR3 disk backup scripts
HEATHZ3.LBR	ZCPR3 for Heath H89 systems
HISTSHEL.NZT	Development of new history shell
HSH15.LBR	ZCPR3 history processing shell
HSH33PAT.LBR	Patch to HSH15 for ZCPR 3.3
IFCOM14.HZP	Help file for IFCOM14
IOPUG.LBR	ZCPR3 I/O Package User's Guide
JB-VFCMD.LBR	VFILER extended CMD file
JLTOOLS.LBR	Supporting tools for JetLDR
JULIAN.LBR	Assembler date conversion routines
KEYMAP.LBR	Function key emulator IOP for ZCPR
KP-TCAP.LBR	ZCPR3 TCAP for Kaypros
KPTRTCAP.LBR	TCAP for Kaypro 10
LAP.LBR 	ZCPR path/LDR utility
LBREXT26.LBR	Extract members from a library
LBREXT3.BUG	LBREXT2 and LBREXT3 bug report!
LBRHLP13.LBR	Read crunched help files
LDR16.LBR	Gen-purpose ZCPR3 package loader
LDSK20.LBR	Logs in disk directories for ZCPR3
LED02.LBR	Z3 Line Editor
LGET11.LBR	ZCPR3 LBR file extract utility
LHELP.COM	ZCPR3 library help file processor
LISTCMD1.PZS	Lists commands from ARUNZ.CMD file
LLDR.LBR	Read files from a library into LDR
LLF11.LBR	Fixed Z3 LBR directory tool
LOADND12.LBR	Updates ZCPR3 system Named Directory
LOCNDO12.LBR	Locates files, performs script tasks
LONG-SUB.MZD	Submit processing under ZCPR 3.3
LONGSUB.ZZ0	ZCPR3 patch for large submit files
LRUNZ302.LBR	Run COM files from a library
LSH10I.LBR	Command line editing shell
LSH10M.LBR	Z System command line history shell
LUP11.PQS	LBR utility for ZCPR3 Z-Node systems
LUSH10.LBR	Library Utility SHell
LUZ3.LBR	LBR file utilities for ZCPR3
LX19.LBR	ZCPR3 Library eXecute tool
M80HACK.TZT	Patches to Macro80/Link80 for ZCPR
MAKLIB12.LBR	Automated library builder
MCOPY47A.BZG	Doc file for a bug in mcopy47a.
MCOPY47B.BUG	Bug in Mcopy version 4.7b with RSX.
MENU41.LBR	ZCPR3 menu front-end processor
MEX+2Z11.LBR	MEX / ZCPR3 shell-like environment
MEX2Z10.LBR	A pseudo-pipe between MEX and ZCPR3
MEX2Z12.LBR	Shell to Z-System from MEX
MKDIR32.LBR	Edit named directory files
MLOADPCH.TZT	Patch to MLOAD for use with XBIOS
MOVE21C.LBR	Moves a file to another user area
MU314.LBR	ZCPR3 memory utility
MUSICBOX.LBR	Demo for relocating macro assembler
NAME10.LBR	Change and delete ZCPR3 dir names
NDRCHG10.LBR	Rename a ZCPR3 named directory
NHSH-Z33.LBR	Save and re-issue commands in ZCPR
NO-SLOT.LBR	Set/display time on no-slot clock
NSWPOZ8D.LBR	NSWP support for Z80DOS time stamp
NSWPPAT.LBR	Patch to NSWP for 32 user areas
NT42.LBR	Write quick notes to disk file
NUCD.LBR	Change Directories with NUBYE
NZ-SAFE.TZT	Secure system for ZCPR 34
NZCOM.DZC	NZ-COM 2.0 is now available - info
NZCOM.MSG	Info on progress of new Z-COM
NZENVADD.TZT	Offsets from ENV address of NZCOM
NZEX-D.LBR	Submit processor for ZCPR 3.3
ORDER.ZZX	Speed up directory search w/ZCPR3
OSH14.LBR	History shell for BackGrounder ii
PACK10A.LBR	Improve hard disk performance
PAGE21.LBR	Controlled-scrolling ZCPR3 typer
PATH31.LBR	ZCPR3 search path tool
PAUSE11.LBR	Pause in ZCPR3 ZEX files
PLF10.LBR	ZCPR33 aliases to process LBR files
PLF21.LBR	View/extract LBR files w/datestamps
POKE10.LBR	Transient POKE command for ZCPR
PPIP18.LBR	File copy program replaces PIP
PRICES14.RZS	Z software price list from Echelon
PRINT20.LBR	Versatile ZCPR3 print utility
PRINTHLP.LBR	Prints ZCPR help files
PROLNKPT.LBR	Customize Prolink for ZCPR3
PROTEC30.LBR	File attribute manipulation for ZCPR
PTCAP12.LBR	Install new TCAP on PBBS systems
PUB.DZC 	Info about Public feature of NovaDOS
PUBPTZ10.LBR	Plu*Perfect Public patch for ZRDOS
PUSH12.LBR	Save current drive/user, registers
PWD14.LBR	Named directory display for ZCPR3
RCOM10.LBR	Allow pgms to use command file list
RCPH-GKT.LZB	Displays ZCPR resident command list
RCPMC.LBR	Z33 file copier RCP
RCPMKE13.LBR	Unix-like MAKE for ZCPR 33
RCPPEEP.LBR	Text browser/lister Z33 RCP
RCPTRGGR.TZT	Info on ZCPR's RCP with trigger key
REG11.LBR	Convert to Zilog and ZCPR3 header
RENAM33A.LBR	Rename files in the ZCPR environment
RENAME33.LBR	Rename files in the ZCPR environment
RENAMZ17.LBR	Z80 file renaming utility
RLX16.LBR	ZCPR33 Library utility
SAK22B.LBR	Wait for user interaction in ZEX
SALIAS13.LBR	Screen oriented Alias generator
SALIAS1H.LBR	Screen oriented alias editor
SAVE04.LBR	transient SAVE for ZCPR3.3
SAVNDR.LBR	Saves ZCPR3 resident Named Directory
SAVSTMP3.LBR	Preserves DateStamper create date
SCZ01BET.LBR	ZCPR version of Small-C 2.1
SDATE10.LBR	Set date for Z80DOS with no clock
SEGLINK.LBR	Links ZCRP3/BGii REL files
SETDZ3.LBR	Patch to SETD for ZCPR3
SETDZ302.LBR	Patch to SETD for ZCPR3 DU reference
SETDZ80.LBR	Set date in library with Z80DOS
SETFIL11.LBR	Define/Display ZCPR3 file name
SFENV.REL	a ZCPR3 Tool
SH20.LBR	Illustrates shells under ZCPR3
SHCTRL11.LBR	Provide control of ZCPR shell stack
SHELL11M.LBR	Turbo Modula-2 shell
SHELLIF.MZD	ZCPR3 MOD for IF/ELSE in a shell
SHELLINI.LBR	Fix for ZCPR3/WordStar shell stack
SHOW14.LBR	Displays ZCPR33 system configuration
SHOWTYPE.PZS	Display ZCPR compatility of COM file
SHSET22.LBR	Build command lines into aliases
SHUTILS2.LBR	ZCPR3 shell variables improved
SHVAR11.LBR	Defines shell variable for Shell SH
SLB36HLP.LBR	Help files for SYSLIB 3.6
SLIB1.LBR	SYSLIB 3.6 Source code modules 0-D
SLIB2.ARK	SYSLIB 3.6 Source code modules E-L
SLIB3.LBR	SYSLIB 3.6 Source code modules M-Z
SLIB4.LBR	SYSLIB 3.6 LIB, SEQ, and ZEX files
SLRLIB.LBR	Z3 .REL files in SLR format
SNAP.LBR	Saves/reloads ZCPR control blocks
SPAWN04.LBR	Have 10 tasks active at one time
SPP10.LBR	Super purge program to erase files
STATPAT.ZZ0	Patch for STAT.COM under ZCPR 3.3
STATPAT2.LBR	Patch to STAT.COM under ZCPR 3.3
STEST.LBR	SYSLIB 3.6 test programs
SUB34.LBR	Submit replacement for ZCPR33
SUGGEST.ZZ3	Suggestions for ZCPR SYStem package
SYSENV.LBR	Source file for ZCPR3 .ENV segment
SYSENV2.LBR	Enhanced System Environment for Z34
SYSFCP.LBR	Source files for ZCPR3 .FCP segment
SYSLIB.CRC	Announcement of SYSLIB 3.6 release
SYSLIB.LBR	SYSLIB 3.6 help files
SYSLIB.REL	SYSLIB 3.6 ready to use REL library
SYSLIBD.DQC	SYSLIB 3.6 Distribution information
SYSLIBD.LBR	SYSLIB 3.6 files create SYSLIBD.DOC
SYSRCP14.LBR	Sources for ZCPR3 .RCP segments
T12.LBR 	Types screen display files
T3DIAL.BUG	Problems and fixes with T3DIAL
T3M-ERR.MZG	T3MASTER/T3SERVER error codes
T4GEN01.LBR	A utility to generate Type 4 prgms.
T4LDR11.ZZ0	Overlay loader code for PRL/SPR file
T4N41.ARK	N41 Calculator as a Z Type-4
TABBY289.ARK	Implementing Echomail under CP/M
TCCHEC11.LBR	TCCHECK to check TCAP files.
TCJ25.MZG	Sage ZSIG Column, TCJ Issue #25
TCJ26.MZG	Sage ZSIG Column, TCJ Issue #26
TCJ27.MZG	Sage ZSIG Column, TCJ Issue #27
TCJ28.MZG	Sage ZSIG Column, TCJ Issue #28
TCJ29.MZG	Sage ZSIG Column, TCJ Issue #29
TCJ30.MZG	Sage ZSIG Column, TCJ Issue #30
TCJ31.MZG	Sage ZSIG Column, TCJ Issue #31
TCJ32.MZG	Sage ZSIG Column, TCJ Issue #32
TCJ33.MZG	Sage ZSIG Column, TCJ Issue #33
TCJ34.MZG	Sage ZSIG Column, TCJ Issue #34
TCJ35.MZG	Sage ZSIG Column, TCJ Issue #35
TCJ36BMM.MZG	Bridger Mitchell's column -- TCJ #36
TCJWSPAT.ZZ0	Make WS4's 'R' command do ZCPR shell
TCVIEW20.LBR	Display ZCPR TCAP entries
TESTER11.LBR	ZCPR3 error reporting for M80
TEX13.LBR	ZCPR Time Scheduling Shell
TIME10.LBR	ZCPR3 time/date programs
TIMEZD12.LBR	View/Set system time with Z80DOS
TLF.LBR 	ZCPR3 alias to type library members
TM-DS10.ZZ0	DateStamper/ZCPR3 TIME10 overlay
TRIM.LBR	Z-Tool to truncate object files
TYPE3HDR.BUG	Fix for type3hdr on interrupt driven
TYPE3HDR.ZZ0	Type-3 environment header code
UNARC.CZD	Writing aliases for ARUNZ
V266OZ8D.LBR	VDE with Z80dos time-stamping
V4LIBS.LBR	Z-System REL Libraries, version 4
VALIAS11.LBR	Loads a Alias command line buffer
VCED18.LBR	ZCPR3 shell edits command lines
VCOMP13.LBR	Visual file comparison
VCOMP20.LBR	Visual comparison of two text files
VERROR17.LBR	ZCPR3 error handler
VF-BOX11.LBR	Activate graphics mode in VFILER
VFILER43.LBR	ZCPR3 file maintenance utility
VISUAL50.AZM	ZCPR 3.3 TCAP for the Visual 50
VLIB.CRC	Announcement of VLIB 1.1 release
VLIB.HLP	VLIB 1.1 help documentation
VLIB.REL	VLIB 1.1 ready to use REL library
VLIB1.LBR	VLIB 1.1 Source code
VLIB2.LBR	VLIB 1.1 ZEX and SEQ files
VLIBD.DQC	VLIB 1.1 distribution documentation
VLIBD.LBR	VLIB 1.1 files create VLIBD.DOC
VLIBMOD.ARK	A modification to the VLIB library
VLU-CMD.LBR	VFILER.CMD interface to VLU 1.01
VLU108.LBR	Video Library Utility
VMENU27.LBR	ZCPR3 menu command preprocessor
VMENUFUN.LBR	Using the ZCPR3 VMENU system
VREN.LBR	Visual RENamer for ZCPR3 systems
VTCAP11.LBR	Database management for TCAP files
W23.LBR 	Use wild cards for all programs
WHEEL32.LBR	Set and Reset the Whell Byte
WORDDEMO.LBR	Word Processing under ZCPR
WS40OZ81.LBR	WS 4.0 overlay with Z80dos date
WS4PAT.LBR	Patch to WS4 for ZCPR terminals
WS4PRNDV.LBR	Use two printers with WordStar 4.0
WS4ZCPR3.FIX	WordStar 4.0 fix for use with ZCPR3
XALIAS11.LBR	Enhanced Z3 ALIAS variant
XB11.LBR	A banked memory system for ZCPR3
XDSK.LBR	ZCPR3 utility for dash-files
XSUBZ14.LBR	ZCPR33 XSUB replacement
YOURSHEL.LBR	Make your programs Shells in ZCPR3
Z-GOLF.LBR	Game of solitaire for ZCPR
Z-MCCORD.AZT	Z-System article by D. McCord
Z-NEWS.3Q1	ZCPR3 newsletter #301
Z-NEWS.3Q2	ZCPR3 newsletter #302
Z-NEWS.3Q3	ZCPR3 newsletter #303
Z-NEWS.3Q4	ZCPR3 newsletter #304
Z-NEWS.3Q5	ZCPR3 newsletter #305
Z-NEWS.3Q6	ZCPR3 newsletter #306
Z-NEWS.3Q7	ZCPR3 newsletter #307
Z-NEWS.3Q8	ZCPR3 newsletter #308
Z-NEWS.3Q9	ZCPR3 newsletter #309
Z-NEWS.4Q1	ZCPR3/SYSLIB/ZRDOS Newsletter #401
Z-NEWS.4Q2	ZCPR3/SYSLIB/ZRDOS newsletter #402
Z-NEWS.4Q3	ZCPR3/SYSLIB/ZRDOS Newsletter #403
Z-NEWS.4Q4	ZCPR3/SYSLIB/ZRDOS Newsletter #404
Z-NEWS.4Q5	ZCPR3/SYSLIB/ZRDOS Newsletter #405
Z-NEWS.4Q6	ZCPR3/SYSLIB/ZRDOS Newsletter #406
Z-NEWS.4Q7	ZCPR3/SYSLIB/ZRDOS Newsletter #407
Z-NEWS.4Q8	ZCPR3/SYSLIB/ZRDOS Newsletter #408
Z-NEWS.4Q9	ZCPR3/SYSLIB/ZRDOS Newsletter #409
Z-NEWS.5Q1	ZCPR3/SYSLIB/ZDROS Newsletter #501
Z-NEWS.5Q2	ZCPR3/SYSLIB/ZDROS Newsletter #502
Z-NEWS.5Q3	ZCPR3/SYSLIB/ZDROS Newsletter #503
Z-NEWS.5Q4	ZCPR3/SYSLIB/ZRDOS Newsletter #504
Z-NEWS.5Q5	ZCPR3/SYSLIB/ZRDOS Newsletter #505
Z-NEWS.5Q6	ZCPR3/SYSLIB/ZRDOS Newsletter #506
Z-NEWS.5Q7	ZCPR3/SYSLIB/ZRDOS Newsletter #507
Z-NEWS.5Q8	ZCPR3/SYSLIB/ZRDOS Newsletter #508
Z-NEWS.5Q9	ZCPR3/SYSLIB/ZRDOS Newsletter #509
Z-NEWS.6Q1	ZCPR3/SYSLIB/ZRDOS Newsletter #601
Z-NEWS.6Q2	ZCPR3/SYSLIB/ZRDOS Newsletter #602
Z-NEWS.6Q3	ZCPR3/SYSLIB/ZRDOS Newsletter #603
Z-NEWS.6Q4	ZCPR3/SYSLIB/ZRDOS Newsletter #604
Z-NEWS.6Q5	ZCPR3/SYSLIB/ZRDOS Newsletter #605
Z-NEWS.6Z6	ZCPR3/SYSLIB/ZRDOS Newsletter #606
Z-NEWS.6Z7	ZCPR3/SYSLIB/ZRDOS Newsletter #607
Z-NEWS.6Z9	ZCPR3/SYSLIB/ZRDOS Newsletter #609
Z-NEWS.7Z1	ZCPR3/SYSLIB/ZRDOS Newsletter #701
Z-NEWS.7Z2	ZCPR3/SYSLIB/ZRDOS Newsletter #702
Z-NEWS.7Z3	ZCPR3/SYSLIB/ZRDOS Newsletter #703
Z-NEWS.7Z4	ZCPR3/SYSLIB/ZRDOS Newsletter #704
Z-NEWS.7Z5	ZCPR3/SYSLIB/ZRDOS Newsletter #705
Z-NEWS.7Z6	ZCPR3/SYSLIB/ZRDOS Newsletter #706
Z-NEWS.7Z7	ZCPR3/SYSLIB/ZRDOS Newsletter #707
Z-NEWS.7Z8	ZCPR3/SYSLIB/ZRDOS Newsletter #708
Z-NEWS.7Z9	ZCPR3/SYSLIB/ZRDOS Newsletter #709
Z-NEWS.8Z1	ZCPR3/SYSLIB/ZRDOS Newsletter #801
Z-NEWS.8Z2	ZCPR3/SYSLIB/ZRDOS Newsletter #802
Z-NEWS.8Z3	ZCPR3/SYSLIB/ZRDOS Newsletter #803
Z-NEWS.8Z4	ZCPR3/SYSLIB/ZRDOS Newsletter #804
Z-NEWS.8Z5	ZCPR3/SYSLIB/ZRDOS Newsletter #805
Z-NEWS.8Z6	ZCPR3/SYSLIB/ZRDOS Newsletter #806
Z-NEWS.8Z7	ZCPR3/SYSLIB/ZRDOS Newsletter #807
Z-NEWS.8Z8	ZCPR3/SYSLIB/ZRDOS Newsletter #808
Z-NEWS.8Z9	ZCP3/SYSLIB/ZRODS Newsletter #809
Z-PLAN.LBR	Alpha Systems' self installing Z-Sys
Z-RIP11.LBR	Install ZPR3 programs
Z-STATUS.LTR	Distribution status of Z-system
Z-SYSTEM.MQG	A user's look at ZRDOS features
Z3-TV803.LBR	Install ZCPR3 on the TeleVideo 803
Z3-WKBK.TZT	Workbook for ZCPR3 installation
Z3-WKBK.WQ	ZCPR3 installation workbook by Conn
Z33-M80.HZW	Changes to assemble ZCPR3.3 with M80
Z33-M80.LBR	ZCPR33 for use with MicroSoft M80
Z33-TM2.LBR	ZCPR33 for use with Turbo Modula 2
Z33-ZASM.LBR	Installing ZCPR33 with ZASM
Z33ANOTE.001	ZCPR33 Application Note 001
Z33ANOTE.002	ZCPR33 Application Note 002
Z33ASSEM.NZT	Change for Z33RCP when using ZAS
Z33DEBUG.LBR	ZCPR33 DEBUG.LIB with HEX calculator
Z33ERR07.LBR	ZCPR 3.3 error handler
Z33FCP10.LBR	ZCPR 3.3 Flow Command Package
Z33FIX.001	ZCPR 3.3 fix to command buffer
Z33IF.MZG	Explanation of 'IF' mystery in ZNEWS
Z33IF14.LBR	Transient ZCPR IF processor
Z33IF15.LBR	Z-System flow control transient
Z33LIB05.LBR	LIB routines for ZCPR Version 3.3
Z33MAKE.LBR	Moves files to new user area
Z33PNOTE.001	ZCPR33 Programming note 001
Z33PNOTE.002	ZCPR33 Programming note 002
Z33PNOTE.003	ZCPR33 Programming note 003
Z33RCP02.LBR	Revised RCP for ZCPR 3.3
Z33TRC11.LBR	Transient RCP for ZCPR3.3
Z33TSS-C.LBR	ZCPR 3.3 for NorthStar Horizon
Z33UPD.DZC	News about ZCPR3.3
Z33UTIL.LBR	ZCPR3.3 Error Handlers
Z33VER09.LBR	Error Handler for ZCPR3.3
Z33VER10.LBR	ZCPR33 screen oriented error handler
Z34-NEW.MSG	Status of new version of ZCPR (3.4)
Z34RCP10.LBR	ZCPR 34 Resident Command Package
Z3CUBE11.LBR	Simulation of a 3-dimensional cube
Z3EAGLE2.LBR	ZCPR3 for Eagle 2
Z3EPQX10.LBR	ZCPR3 for Epson QX-10
Z3HELP10.LBR	Help for Z-system and utilities
Z3HELP14.LBR	Help files for ZCPR3
Z3INS15.LBR	ZCPR3 utility installation program
Z3INSTAL.LBR	ZCPR3 Installation manual
Z3INSTAL.TZT	Article on ZCPR3 installation
Z3INSTP.LBR	ZCPR auto-installer for Turbo Pascal
Z3KEY14.LBR	ZCPR3 assign char strings to keys
Z3KEYREL.LBR	An RCP for Z3KEY using SEGLINK
Z3LIB.CRC	Announcement of ZLIB 1.3 release
Z3LIB.LBR	Z3LIB 1.3 help documentation files
Z3LIB.REL	Z3LIB 1.3 ready to use REL library
Z3LIBD.DQC	Z3LIB 1.3 distribution documentation
Z3LIBD.LBR	Z3LIB 1.3 files create Z3LIBD.DOC
Z3LIBHLP.LBR	Help files for Z3LIB version 1
Z3LOC13.LBR	Display location of CCP, BDOS, BIOS
Z3LOC15.OZJ	Show addresses of CP/M system
Z3MD-60K.LBR	ZCPR3 for Morrow MD.
Z3NEW105.LBR	Replacement for NEW command
Z3TCAP26.LBR	ZCPR3 terminal emulation program
Z3USER.LBR	The user's perspective of ZCPR3
Z3XEROX.LBR	ZCPR3 for the Xerox 820-II or 16/8
Z3Z100-1.LBR	ZCPR3 for the H/Z100
Z3Z100-2.LBR	2nd Library for ZCPR3 on H/Z100's
Z4-TALK.LBR	Presentation on ZCPR4 - Richard Conn
Z80DNZCM.LBR	Auto-install Z80DOS2 with NZCOM
Z80DRSX.LBR	Z80DOS converted to NZ-COM standard
ZAP#1.LBR	ZSYSTEMS Application Note #1
ZAP.LBR 	System monitor RCP for ZCPR3
ZAPG.SZ 	ZCPR3 Applications Programmer Guide
ZAS-SLR2.DQC	Ongoing discussion of ZAS assembler
ZAS-SLR4.DQC	The last of the CONN/SAGE discussion
ZAS-STD.DQC	Comments on use of ZAS assembler
ZBGQ11.LBR	Easy loading of BackGrounder
ZBOXWYSE.LBR	Graphics for Wyse 50 Terminal
ZBYE11C.MQC	BYE remote console RCP for ZCPR3
ZCPR.AZT	Non-technical discussion of ZCPR
ZCPR1.ARK	ZCPR 1.0 enhanced CCP for CP/M 2.2
ZCPR3.DZR	Files in Software Library 33 - ZCPR3
ZCPR33.FZR	Descriptions of ZCPR 3.3 files
ZCPR33.LBR	ZCPR 3.3 Command Processor
ZCPR33A.LBR	Special ZCPR33, allows flow control
ZCPR3ATR.LBR	ZCPR3 installed for SWP's ATR8000
ZCPR3SRC.LBR	Sources for ZCPR3 CCP
ZCPRH89.LBR	Easy install ZCPR-1 on Heath H89
ZCRCK12.LBR	Calc. CRCK & CHEK values under ZCPR3
ZDKCOM13.LBR	Key file compiler/decompiler for ZDE
ZEDFILE.LBR	ZCPR3 adaptation patch for EDFILE
ZERR11.LBR	Error handler for Z-System
ZEX32.LBR	ZCPR submit processor replacement
ZEX403A.LBR	Submit file processor for ZCPR
ZEX50.LBR	New version of ZCPR ZEX processor.
ZF10KZ30.OBJ	Zfiler vers K for ZCPR 3.0
ZF10N.LBR	Z-System Filer Tool
ZFDOCS.LBR	Documentation for ZFILER
ZFILER.BZG	Bug in Zfiler
ZFILES14.LZT	Information on Z-System Utilities
ZFILRCMD.LBR	ZFILER command to use resources
ZHELPR16.RQS	Where to get ZCPR3 installation help
ZLB-A.LBR	Auto-Install ZCPR for Ampro
ZLB-B.LBR	Auto-Install ZCPR for Ampro
ZLB-C.LBR	Auto-Install ZCPR for Ampro
ZLB-D.LBR	Auto-Install ZCPR for Ampro
ZLB-E.LBR	Auto-Install ZCPR for Ampro
ZLBGEN.LBR	Install Utils. for Ampro Z3 System
ZLBR12.LBR	ZCPR3 library management tool
ZLDIR.LBR	ZCPR3 Library Directory Tool
ZLIB1.LBR	Z3LIB 1.3 Source code part #1
ZLIB2.LBR	Z3LIB 1.3 Source code part #2
ZLIB3.LBR	Z3LIB 1.3 ZEX and SEQ files
ZLT11.LBR	ZCPR compressed/library file typer
ZLUX26.LBR	Library Utility eXtension for ZCPR
ZMANG21D.LBR	Latest version of ZMANAGER
ZNODES51.LZT	List of ZNODE BB systems
ZPATCH13.LBR	Screen-oriented ZCPR3 file patcher
ZPROBLEM.TQT	ZCPR3 problems - note from Rick Conn
ZRDOS-WS.LBR	Help files for ZRDOS
ZRDOS12.DZC	Changes to ZRDOS Version 1.2
ZRDPUB10.LBR	ZRDOS fix losing public attribute
ZSCLKS.LBR	Info for clock routines for ZSDOS
ZSDOS.AZN	Software list for ZSDOS/DateStamper
ZSIGPOL1.DQC	Opening policy statement from ZSIG
ZSSTAT19.LBR	Video-oriented replacement for STAT
ZSTD.DQC	Info on development of new Z System
ZSYSTEM.IQS	List of over 100 ZCPR3 utilities
ZTIME23.LBR	Kenmore Ztime RTC reader program
ZTXTTOWS.LBR	ASCII-to-WordStar for ZCPR3
ZUTILBUG.0Z2	Latest bug report for ZCPR programs.
ZVER9FIX.LBR	ZCPR 3.3 error handler bug fix
ZWORD3.TQT	Questions & answers - ZCPR3/ZRDOS
ZXLATE14.LBR	8080 to Z80 source code translator

    Library 34. Commodore C128 CP/M

-CATALOG.800	SIG/M C128 CP/M sampler #1 catalog
-CATALOG.801	SIG/M C128 CP/M sampler #2 catalog
1581FRMT.COM	Format C128 1581 disk on CP/M
1581SYS.COM	Modify C128 CP/M system for 1581 drv
6DECSRC.LBR	Commodore C-128 BIOS source code
801PRT11.LBR	Lists files on MPS801/803/1525 prntr
ARCOPY.ARK	Enhanced PIP File Copier
ASCIISYS.LBR	Converts C128 Dec. 6 system to ASCII
B-29COMM.ARK	B-29 Shell installed for C-128
B1PBBS.EQU	BYE510 EQUs for c128 & Hayes compat
B5C-C128.IZS	Clock insert for PBBS and C128
B5C8-2E.IQS	BYE5 insert for Commodore 128
BIOS4MOD.LBR	Add serial printer on BIOS4 for C128
BIOSR4.ARK	Commodore C128 CP/M enhanced BIOS
BYE-ON.1Z8	Setting up an RCP/M-BBS on a C-128
BYE128.DOC	Installing BYE510C on the C-128
BYE128.LBR	Files for running BYE on the C-128
BYE1670E.LBR	Run BYE on C128 and 1670 modem
C128-MEX.COM	MEX 114 set up for the C-128
C128-NEW.DOC	Fix for C128 BIOS modem support
C128-NEW.IRV	Updating C128 BIOS to support modem
C128BYE.ARK	C-128 BYE for PBBS on A: drive
C128CMPT.DZC	Disk/Data transfer programs for C128
C128LOAD.LBR	Transfer CP/M files to CBM disk
C128RPN.CZM	Full-Screen calculator for C128
C128SYS.ARK	C-128 system for use with BBS
C128TVX2.LBR	Full screen text editor for C-128
C1571-2.COM	Commodore C128 disk write speedup #2
C8FILCPY.LBR	Copies files using virtual drive E:
CBM-ROMS.UZD	Update of ROMS for C-128 systems
CCP128.COM	C-128 CCP.COM
CHR128-2.LBR	Character set loader/editor for C128
CKCRC11.ARK	Checks for accurate file storage
CLOCK128.LBR	Use RightTime clock to set C128 time
COMMODOR.TZT	Commodore/Kaypro compatibility
CONF2.COM	Commodore C128 CP/M system configure
CONF2.HLP	Help for CONF2.COM a C-128 utility
CP4-C128.LBR	KERMIT 4.05 for the Commodore C-128
CPM LOADER	C128 PRG converts to CP/M format
CPM271.168K	C128 CP/M <--> CBM transfer program
CPMBEGIN.DOC	Instructions for Just starting CP/M
CPMPRMR1.TXT	CP/M+ Primer -- The DIR command
CPMPRMR2.TQT	CP/M+ Primer -- Part 2
CPMPRMR3.TQT	CP/M Plus primer -- Part 3
DASMDAS.LBR	Z-80 Disassembler for C128 CP/M mode
DBASEPIP.ARK	Revised dBase article by Carl.H
DIN.CHR 	Character set for CSLOAD.COM
E-BASIC.LBR	Basic Compiler
EDFILEC8.ARK	Disk File Editor for C-128 CP/M
FATCATC8.ARK	C128 CP/M files for FATCAT24.LBR
FE-FMTS.TXT	Format Executive V4.0 Formats
FE-V40.INF	Format Executive 4.0 information
FORMAT81.LBR	Format the 1581 on C128 under CP/M
IMC128.LBR	IMP for C-128 - all disk drives
INTERFAC.DZC	Article on RS-232 Nul Modem
JUGGDEMO.COM	Demo - C128 CP/M disk format utility
KAYPRO.RSX	KAYPRO video routines for C-128
KEY128-2.ARK	Save key configurations on C-128
LABEL.ARK	C-128 1571/81 disk label program
M7-C1660.AQM	MDM7 overlay--C128, 1650/1660 modem
M7-C1670.AQM	MDM7 overlay for C128 and 1670 modem
M7165060.ASM	Modem7 overlays for the 1650, 1660
M7FNK.LBR	Change function keys for MDM740
M7LIB.LBR	Change phone directory for MDM740
MDM71650.CQM	MDM740 for C128 with 1650 modem
MDM7166D.CQM	MDM740 for C128/1660 modem w/car det
MDM71670.CQM	MDM740 for C128 and 1670 (or RS-232)
MDM740.HQP	MDM740 help file structured from DOC
MDM74DOC.LBR	Documentation files for MDM740.COM.
MEMEXPLR.COM	C-128 MEMORY EXPLORER
MEXHELP.DZC	A short tutorial on MEX.COM
MXM-C128.AQM	MEX overlay - Commodore C-128
MXO-C128.AQM	MEX overlay - Commodore C-128
NEW2CPM.DOC	GEnie Help File for C-128 CP/Mers
NEWSYS2.COM	C128 BIOS update #2 for modem port
NFORMAT.COM	New format utility for the C-128
NUC128-1.IQS	NUBYE insert for Commodore C-128
PBBS8COM.ARK	C-128 PBBS COM files for A0: & A14:
PIP-HELP.TXT	Help with C128 CP/M PIP command
PIPMAG1.ARK	C128 CP/M Online Magazine #1
PIPMAG2.ARK	C128 CP/M Online Magazine #2
PIPMAG3.ARK	PIPMAG Issue #3 For C-128 Users!!
PRINTING.HLP	C128 configure pgm printer options
PROFILE.SUB	Loads date and time at sys. prompt
QT-C128.LBR	Terminal program for the C128
QT41D128.ARK	Qterm for the C-128 w/1571's
RAMPAK.ARK	C128 ramdisk utils with PROFILE.SUB
RAMPAK.DOC	Description of RAMPAK.ARK for C128
RAMPAKD.ARK	Documents for RAMPAK Utilities
RDCBM21.LBR	C-128 DOS to CP/M file copier
RDMS233C.LBR	Read MSDOS disks on Commodore C128
RDSKINFO.DOC	How to set C128 ramdisk drive letter
SPZAP128.ARK	C-128 full-screen disk editor
STARTUP.ARK	Decompression Utilities for C-128
STARTUP.DOC	Doc File for STARTUP.ARK
SZAP-C33.LBR	C-128 full-screen disk editor
SZAP-C33.MQC	Source file for C128 SUPERZAP
TBOHIRES.PZS	80 column graphics for C128 CP/M
TRANRTC.ARK	Text of Transactor RTC on 31AUG88
UNERASE.ARK	Unerase.Com for the C-128 w/Docs
UNIDRIVE.LBR	Use more CP/M disk formats on C-128
UTIL128.ARK	Disk Utilities for the C-128
UTL128-1.LBR	C128 system date, time, version #
VDCDEMO.LBR	Hi-res Demo using the VDC (8563)
VDCLIB13.LBR	VDC Source Routines in 'C'
VDE-C128.ARK	VDE266 for the Commodore C=128
VDO-C128.LBR	VDO memory based editor for C-128
WHYCPM.DOC	Article on C128 CP/M+ features
WORDSTAR.IQF	Customizing WordStar on the C-128
WS-C128.AZM	Set C128 video attr/delays for WS4.0
WS4COLOR.ARK	Full COLOR for WordStar 4 on C128
WUMPUS.LBR	Game for C-128 CP/M

    Library 35. Apple CP/M

ALS+MOD2.LBR	mods for the Apple ALS+ CP/M system
AP2-PICS.LBR	Apple // I/O for PICS & ROS BBS
AP40TRK.LBR	40 tracks for Apple w/Applicard
AP40TRK.TZT	40 tracks for Apple w/Softcard
AP60ZCPR.LBR	ZCPR3 for Apple Softcard 60K
APCLKTC.LBR	Apple Softcard/Thunderclock code
APCPMXFR.LBR	CP/M to Apple DOS file transfer
APGRAF.LBR	Pascal Grafx for Softcard and AEng
APL-BB.0Z1	CP/M RT BB Apple Threads
APLMODEM.AZM	Apple Softcard Modem program
APLSND.PAS	Apple CP/M music routines from Turbo
APLUTIL.PP	Apple ProPacked CP/M Utilities
APLVIDEX.ARK	Apple ][ w/Videx screen speedup
APMBOOT.ASM	MODEM bootstrap pgm for Apple CP/M
APPICSAV.LBR	PICS for Apple and Avatex 2400 mdm
APPLDISK.DZC	Info about Apple II soft sector disk
APPLEIBM.NZT	Apple <==> IBM Read/Write Scheme
APPLUTIL.LBR	CP/M to Apple DOS 3.3 conversion pgm
B5A7-1.IZS	BYE5 insert - Apple ][ w/CCS 7710
B5AA-3.IQS	BYE5 insert for Apple/Applicard/SSC
B5AB-1.IQS	BYE5 insert for Apple/ALS card/SSC
B5AB-3.IQS	BYE5 insert - Apple ALS/SSC card
B5AC-1.IQS	BYE5 insert for Apple/Soft/Applecat
B5AN-1.IQS	BYE5 Insert - Apple ][+
B5AP-2.IQS	AppleII/Mtn CPS ser. insert for BYE5
B5AS-2.IQS	BYE5 insert for Apple/Softcard/SSC
B5C-APTC.IQS	BYE5 clock insert for Apple
B5DC-1.IQS	AppleII/Hayes MM100/80-103 inst BYE5
CARDZ180.INF	New Apple CP/M card w/64180
CONTUR11.LBR	Graphics for Applicard and //e
CP409A68.CZM	Kermit-80 ver. 4.09 - Apple II/6850
CP409APL.CZM	Kermit-80 ver. 4.09 - Apple II/6551
CPMAP60.PCH	Apple II w/Microsoft Z80 BIOS fix
CZ-CW10.LBR	Morse Code for Applicard & CardZ180
CZ-DHR01.LBR	DHR Graphics for CardZ180 //e & //gs
CZ-DVR10.CZM	Displays list of CardZ180 Drivers
CZ-NOTE.0Z1	CardZ180 Serial Cable Notes
CZ-PAT10.CZM	CardZ180 Option Patcher
CZ-UTIL1.LBR	Driver Utilities for CardZ180
I2A2-3.AZM	IMP Overlay - Apple //c
I2A3-3.AZM	IMP Overlay - Apple ///
I2AP-11.AZM	IMP Overlay - Apple II computers
I2AV-1.AZM	IMP Overlay - Apple PCPI Applicard
I2GS-1.AZM	IMP for Apple //gs w/Softcard
I2GS-2.AZM	IMP for Apple //gs w/Applicard
IMPAP2C.COM	IMP for Apple //c
LINK10.ARK	Transfer files Apple CP/M <-> MSDOS
MEX-AP54.HEX	ready-to-run MEX for PCPI (HEX file)
MEX-AP61.HEX	hex dump of MEX for Softcard
MEX-AP61.PP	Propacked Apple MEX-AP61
MORT-APL.LBR	A Mortgage program for Apples
MXC-MC10.AZM	MEXplus Clock ovly for Mountain CPS
MXH-AP30.AQM	MEX overlay Apple Super Serial card
MXH-AP55.AZM	MEX for Applicard w/Ring Buffer
MXH-AP61.AQM	MEX Overlay - Apple w/Softcard & SS
MXH-CZ10.ZZ0	MEX overlay for CardZ180
MXH-CZ11.LBR	MEX overlay for CardZ180
MXM-MM3.AQM	MEX Overlay - Apple2 SS/Nov JCAT
MXO-AC01.AQM	MEX overlay-ApplecCatII Softcard/ALS
MXO-AP12.AQM	MEX overlay - Apple 2 various serial
MXO-AP30.AQM	MEX overlay-Apple2,2+,2E, var serial
MXO-AP31.AQM	MEX overlay - Apple2 MtnHdw or PCPI
MXO-AP50.AQM	MEX overlay-Apple2E, PCPI, SS card
MXO-APCC.AQM	MEX overlay-Apple2 var serial cards
MXO-CZ02.LBR	MEX overlay for CardZ180
MXO-GS10.AZM	MEX Overlay - Apple computers
MXT-AP31.AZM	MEXplus term ovly for Apple
PCPI-M80.INF	patch to ALDS M80 for Applicard
PCPI-MON.LBR	6502 monitor calls from PCPI CP/M
PCPI-RAM.LBR	ramdisk for PCPI and //e (built-in)
PCPI-RTC.LBR	RTC for Applicard using CTC
PCPI-SIO.LBR	support for Applicard Z80-SIO card
PCPI-UG.1Z4	Applicard UG Newsletter #104
PCPI-VDX.LBR	BGii screen driver for Apple/Videx
PCPI-WS4.AZM	Applicard/Wordstar 4.0 Patch
PCPI-XY.BZS	VTAB and HTAB for PCPI w/MBASIC
PCPI/IOB.IZF	IOBYTE info for Applicard
PCPI/PDA.LBR	Applicard/Pure Data Serial Card
PCPI/SRC.LBR	sources for Applicard ZCPR3
PCPI/UG.1Z1	Applicard Newsletter #101 (#1)
PCPI/UG.1Z2	Applicard Newsletter #102
PCPI/UG.1Z3	Applicard UG Newsletter #103
PCPI/UG.INF	a proposal for an Applicard UG
PCPI/Z3.LBR	ZCPR3 for PCPI Applicard
PCPI/Z33.LBR	ZCPR3.3 CPR's for Applicard
PCPI01.NZT	Random notes on the Applicard
PCPI6502.MZP	6502 memory map for apple with PCPI
PCPIAS12.AZM	Applicard/Z3/Wordstar 4.0 fix
PCPIBAUD.LBR	set baud on Applicard/Super Serial
PCPIBDOS.MZC	bdos patch for Applicard
PCPIBOOT.AQM	Customize Applicard boot message
PCPIBYE1.LBR	Applicard Super Serial BYE/KMD
PCPICALC.RCP	CALRCP11 ready-to-run for Applicard
PCPICLK2.LBR	DateStamper support w/ PCPI card
PCPICLK3.LBR	Full-Screen Clock for Applicard
PCPICOLR.LBR	color for Apple PCPI card
PCPIDB11.CZD	dBase DATE.CMD Applicard NoSlotClock
PCPIDBII.FIX	Fixes DBII and Applicard problem
PCPIDHRY.LBR	Dhrystone Test for Applicard
PCPIDVR6.LZT	List of Applicard Drivers
PCPIFAST.CZM	Speed Tester for Applicard
PCPIFC33.LBR	ZCPR3.3 FCP for PCPI Applicard
PCPIFLSH.LBR	Applicard DVR for Synetix Flashcard
PCPIFST6.ARK	Speed-Up info for the Applicard
PCPIGPRT.LBR	use applicard game port as SIO
PCPIGRF2.LBR	Applicard DHR Graphics, v2
PCPIGRFX.LBR	Graphics for the Applicard
PCPIGRLR.LBR	Applicard/Grappler 8th-bit Driver
PCPIGRU1.LBR	Graphics utility for PCPIGRF2
PCPIMMII.LBR	Applicard/MicroModem II Set-Up
PCPINSC1.LBR	Apple //e, Applicard, NoSlotClock
PCPIPM11.ZZ0	Applicard/Poor Man's Network driver
PCPIRC33.LBR	ZCPR3.3 RCP for PCPI Applicard
PCPIRCP2.LBR	alternate RCP for Applicard ZCPR3
PCPIRNG1.LBR	Ringbuffer Driver Applicard/SSC
PCPISCR2.LBR	PCPI BackGrounder ii screen driver
PCPISSCI.DVR	Applicard/SSC Interrupt Driver
PCPITIME.LBR	PCPI/DS1216E/Turbo Modula-2 support
PCPIULTR.LBR	Applicard/UltraTerm ideas
PCPIUNI.LBR	Applicard .DVR for UDC and 3.5/800K
PCPIVERS.AZM	Versacard support for Applicard
PCPIXFER.LBR	Transfer between PCPI CP/M & DOS3.3
PCPIZ3V2.MZP	Z80 memory map for Applicard/ZCPR3
PCPIZBUS.IZF	Applicard Z80 pin-out and Port Info
PCPIZRDS.NZT	Applicard/ZRDOS patch
PICS-AP2.LBR	Apple 2 drivers for PICS 1.5
PMO-CZ10.LBR	Poor Man's Network for CardZ180
QUIETRAM.DVR	59K RAMdisk .DVR for Applicard //e
SSCDRVR.AQM	Apple SSC interrupt driver
THUNDER.AZM	Softcard I/Thunderclock routine
TRAPPLGR.LBR	Turbo-Pascal to use Apple graphics
WSPATCH.LBR	Hints on patching WordStar for Apple
X10OVR15.AZM	Apple/PCPI overlay for X10V43.LBR
Z80SALE.TXT	Z80 (CP/M-80) card & Turbo Pascal
ZMO-AWS1.ZZ0	ZMP overlay for Applicard
ZMO-CZ11.ZZ0	ZMP Overlay for CardZ180

    Library 36. Kaypro CP/M

256CRKT.UPD	Corrected 256K Kaypro RAM circuit
256NEW.ANS	Answer to Kaypro RAM upgrade problem
84KP256.LBR	256K RAM for the KayPro '84's
84KP256A.ARK	190K RAMdisk for '84 Kaypros - $40
ARTIE71.LBR	Block graphic editor for Kaypro
ARTIST.LBR	Drawing program for Kaypro in Turbo
AUTOBOOT.ARK	AUTOBOOT.WS & MicroSphere ramdisk
AUTOBOOT.WZ	Tips on auto-start at Kaypro bootup
AUTOKEYS.LBR	Configure Kaypro keypad
B5C-ADV.IQS	BYE5 clock insert, Kaypro/Advent RTC
B5C-KPAV.IZS	BYE5 clock overlay - Kaypro Advent
B5KP-1.IQS	KayPro insert for BYE5
BARGRAPH.LBR	Configure/print bar graphs on Kaypro
BGK84SCR.LBR	Source for Kaypro '84 screen driver
BIOSMR12.LBR	Improved Kaypro BIOS fast/more storg
BKRSM11.LBR	Information on Kaypro RCP/M set-up
CLONEWAR.LBR	Pits you against your evil clone
COPY.TZT	Kaypro autoboot a command at startup
DCOM.TZT	Uncovering some secrets of D.COM
DDRAW-20.LBR	A graphics utility for Kaypros
DDRAW32.LBR	Updated graphics utility for Kaypros
DSHHH-KP.LBR	Modify SD for Kaypro cursor
DUALPORT.LBR	Multiple console displays for Kaypro
DUMPKP1.LBR	Screen dump program for Kaypro 1
DVORAK.TQT	Replace Kaypro keyboard with Dvorak
EXKKEYS.LBR	Add more keys to the Kaypro keyboard
FASTTERM.LBR	Fast terminal program for Kaypro
FLIGHT.LBR	Aircraft Instrument simulation
FLTKP100.LBR	Kaypro transfer to/from TRS mod 100
HARDDISK.BUY	Installing a hard disk on the Kaypro
HARDDISK.TQT	Add a hard disk to Kaypro-84 models
HARDNOTE.TQT	Install harddisk on Kaypro /TurboROM
HARNESS.TZT	Wiring harness problems with Kaypros
HMK2112.LBR	XMODEM/YMODEM/ZMODEM for Kaypro
HOTKEY11.LBR	Arrow/keypad redefinition for Kaypro
I2KP-3.AZM	IMP overlay - Kaypro computers
INTTERM.LBR	Kaypro interrupt driven term program
K-DIAL11.LBR	Phone auto-dialer for Kaypro '84
K10Z33.LBR	ZCPR 33 install files for Kaypro 10
K10ZCPR3.LBR	Installing ZCPR3 on Kaypro 10
K16---K2.TZT	Connecting a Kaypro 16 to Kaypro 2
K1SCREEN.IZF	Video escape sequences for Kaypro 1
K1Z3IN.LBR	Easy ZCPR3 install - Kaypro I
K256BIOS.LBR	Software needed for Kaypro 256K mod
K4SKETCH.LBR	Draw lines and pixels on Kaypro '84
K4X.DZC 	Enhancements for Kaypro
K4ZSYSIN.DQC	Implementing ZCPR3 on Kaypro 4-84
K83Z33.LBR	ZCPR33 install files for Kaypro 83
K83ZCPR3.LBR	ZCPR3 for Kaypro 1983 II's and IV's
K84CHESS.LBR	Chess for video model Kaypros
KAY-DISK.IZF	Kaypro floppy disk formats
KAY256.LBR	Install 256k chips on the Kaypro IV
KAYAK.LBR	Kayak race for Kaypro systems
KAYDIAG.LBR	Diagnostics for Kaypro II & IV.
KAYEASEL.LBR	Electronic graphics easel for Kaypro
KAYINFO.LBR	Kaypro Information -- Keyboard etc.
KAYMAINT.TZT	Maintenance tips for Kaypro systems
KEYPAD.LBR	KAYPRO Keypad and cursor string prog
KIIHLITE.TZT	Non-Graphics Kaypro NSWP highliting
KMK484-1.AZM	MB-KMD Overlay - Kaypro 4-84
KP-ARROW.LBR	Change values of Kaypro's arrow keys
KP-CALUP.LBR	Kaypro phone database/dialing util.
KP-EDIT2.LBR	Small WordStar-like editor for Kpro
KP-HOST.LBR	Files for remote system on Kaypro
KP-MEMBR.LBR	Database manager for user groups
KP-OFF.LBR	Resets Kaypro screen, drives, modem
KP-RESET.LBR	Cold boot utility for Kaypros
KP-TURBO.ROM	Plu*Perfect enhanced Kaypro BIOS
KP-UBIOS.MZC	Kaypro BIOS for 'U' ROM
KP-ULTRA.TZT	New Z280 ULTRABOARD for Kaypros
KP-VDUMP.LBR	Screen dump for Graphic-type Kaypro
KP-VERSN.TZT	Cross reference of Kaypro ROM/BIOS
KP-VT52.LBR	VT52 terminal emulator for Kaypro
KP-ZDOS.LBR	Kaypro Self-install CP/M look-alike
KP10MONY.LBR	Money management package - Kaypro10
KP10USER.LBR	MASMENU replacement for Kaypro 10
KP2-EDIT.LBR	VDO-like text editor for Kaypro
KP25LINE.LBR	Correct slow screen with TurboROM
KP2XU-Z3.LBR	ZCPR3 install files for Kaypro 2X
KP484Z3.LBR	Kaypro ZCPR3 installation files
KPARKPAT.ARK	Patch ARK02.COM for '84 Kaypro RTC
KPATTERN.LBR	Kaypro graphics demo programs
KPBUMBER.ARK	Bumber stickers for Kaypro
KPBYE5.LBR	RCP/M system for Kaypro
KPCT135Y.LBR	Graphic clock and timer for Kaypro
KPCUR20.LBR	Set shape of Kaypro cursor
KPCW.LBR	Morse code practice using Kaypro
KPDD10.LBR	Directory utility for the Kaypro
KPDEV.LBR	Connecting printers, peripherals
KPDIAG.LBR	Diagnostic utilities for the Kaypro
KPDIR.LBR	Directory program for Kaypro
KPEDFONT.LBR	Editor for Bradford font files
KPENG13.LBR	Disk analysis program for Kaypro
KPFIXSEL.AQM	Patch for select error on Kaypro
KPGRAFIC.TQT	Info about graphics on the Kaypro
KPGRAPH.PQS	Turbo graphics for the Kaypro
KPGRDISP.ARK	Graphics display of Kaypro logo!!
KPGRFCL1.LBR	A graphic clock for the Kaypro
KPHANDY+.LBR	HANDY+10 for Kaypros
KPIMP245.LBR	IMP 245 for Kayrpo with Avatex modem
KPKBD.LBR	Printable Kaypro keyboard templets
KPKEYS.LBR	Dynamic numeric pad definition util.
KPLD517U.LBR	Kaypro video text file display
KPLTIME.AQM	TIME program for Kaypro with Legacy
KPMAPSYS.LBR	Shows TPA available on Kaypro
KPMITE.FZT	MITE on Kaypro 4 with external modem
KPMOVCPM.DZC	Problems with Kaypro 1 MOVCPM
KPNEWTRM.LBR	Kaypro interrupt driven termnial pgm
KPNUROM.LBR	Enhanced ROM for '83 Kaypros
KPORTS85.DZC	Addemdum to Kaypro Users's Guide
KPRAMDSK.LBR	Add 256K RAM disk to Kaypro '84
KPRODEMO.LBR	Connect six Kaypros for demos
KPROMODS.TZT	Modifications to the Kaypro
KPRTLST+.LBR	Formats 3 across page from MAST.LST
KPRULE25.LBR	Put column rule on Kaypro 25th line
KPSETKEY.LBR	Keypad re-definer for Kaypro
KPU87MOD.IQF	Fix on early Kaypros for data errors
KPVGAM1A.LBR	Games for Kaypro - Part 1
KPVGAM1B.LBR	Games for Kaypro - Part 2
KPVGAM1C.LBR	Games for Kaypro - Part 3
KPVGAME.LST	List of video games for Kaypro
KPVID.LBR	Kaypro programs use screen functions
KPVLU102.LBR	Video library utility for Kaypros
KPVLUV.CZM	Video LBR utility for Kaypro '84
KPWORM.LBR	WORM memory test for Kaypro Turborom
KQUESTNS.TZT	Z-System Kaypro questions/answers
KRAMDISK.TZT	Make most of Kaypro with a RAM disk
KREEP.LBR	Kaypro Real Easy Entry Program
LIFE-PAS.LBR	Life simulation in Turbo Pascal
LINE25KP.DQC	Using line #25 on Kaypro screen
M100-KP.ARK	Kaypro <--> TRS100 file transfers
MASMENU.TZT	Thoughts on Kaypro's master menus
MBC-KPRO.AQM	MBYE Clock insert for Kaypro II
MBK484-1.AQM	MBYE insert for Kaypro 4-84
METAKEYS.LBR	Redefine Kaypro's vector keys/keypad
MEX114KP.NQT	How to bring up MEX on Kaypro 2X
MUBYE33.ARK	Multi-User MBYE33 for '84 Kaypros
MXC-KC10.AZM	MEX Overlay - Kaypro Kenmore Ztime-I
MXH-KG11.AQM	MEX/MEX-Plus overlay-Kaypro ext. mdm
MXH-KP53.AZM	MEX Overlay - Kaypro computers
MXO-K484.AQM	MEX overlay - Kaypro 4/84 int modem
MXO-KP43.AQM	MEX overlay - Kaypro int/ext modem
MXO-KP50.LBR	MEX Overlay - Kaypro int/ext modem
NCCP84.LBR	CCP replacement for Kaypro 4-84
NORING.LBR	Set Kaypro internal mdm answer mode
NSVIDEO.TZT	Reverse-video NewSweep on Kaypros
NUC-ADV.INS	NUBYE Clock insert - Kaypro Advent
NUC-KP4.IQS	NUBYE clock insert for Kaypro
NUGAME.LBR	MBASIC games for the Kaypro
NUZ2TURB.LBR	ZCPR2 for Kaypro-10 w/Turbo-ROM
OMNIDEMO.LBR	Window interface for Kaypro
PAGEDEMO.LBR	Demo release of ARTPAGE for Kaypro
PATCHARK.ARK	Kaypro RTC use for ARK035 or later
PCALC110.PZT	Use reverse video with Perfect Calc
PEGASUS.LBR	Children's spelling game for Kaypro
PF2ASC.LBR	Convert Perfect Filer files to ASCII
PHN21.LBR	Modem Dialer and number lister
PIX11.LBR	Play with Kaypro graphics
PROFILES.LBR	Index of PROFILE articles - June, 85
PUTZCPR.LBR	Easy install of ZCPR 1.4 on Kaypro
RAMTOOLS.LBR	RAM resident utility for Kaypro 4'84
REALTIME.TZT	Accessing real time clock in Kaypros
RTTY.AZM	Baudot Teletype for Kaypro
SAVECRT.LBR	Turns off screen on video Kaypro
SCRGEN1.LBR	Screen generators for Kaypro
SD-QUIET.LBR	SD mod to quiet Kaypro 2-84 keyboard
SD125KAY.LBR	SD125 configured for Kaypro w/ZCPR3
SETKP-IO.LBR	Set Kaypro modem/printer serial port
SHAFT.LBR	Demonstration of graphics on Kaypro
SIDEARM.LBR	Limited notepad SideArm demo
SKIPMAP.LBR	Skip rebuilding of allocation table
SPZ33-WS.LBR	Full screen disk editor for Kaypro
SSTAT-KP.LBR	STAT replacement for Kaypros
STATLINE.LBR	Turn Kaypro status line On/Off
TDD.LBR 	Kaypro Telecommuncation for the Deaf
TIMER.LBR	A countdown timer in Turbo Pascal
TOON12.LBR	Kaypro II-'83 save screen to disk
TRANSKP4.LBR	Transfer files between CP/M & MS-DOS
TROMHINT.LBR	Advent TurboROM Kaypro video speedup
TROMNOTE.LBR	Advent TurboROM Kaypro video speedup
TROMPAT2.LBR	TurboRom patches for Kaypro software
TRPATCH.LBR	Patch files for Kaypro with TurboROM
TRPATCH1.LBR	Patch software on Kaypro w/TurboROM
TRS2KPRO.TQT	Pass data from Kaypro to TRS mod 100
TRSTATLN.LBR	Enable/disable 25th line w/TurboROM
TURBKPEX.LBR	Forces cold boot for harddisk start
TURBOROM.DQC	Theory of the TurboROM's operation
TURBOSAF.LBR	PARK heads of fixed disk w/TurboROM
TURBOSCR.IQF	'Slow screen' problem with TurboROM
TYPEKP84.LBR	Touch typing tutor for Kaypro '84
UARTKPRO.DQC	Using the Z80-SIO on the Kaypro
UROMKEYS.AZM	Redefine function keys on Kaypro 'U'
VT100KAY.LBR	VT100 emulator for Kaypro
WS-KP25+.LBR	IBM-style help line for Kaypro WS
WS-UROM.FQX	Patch to WordStar for Z-system BIOS
WS4KP.LBR	Mods for WordStar screen control
WSKP.ARK	Redefine keypad for Kaypro/WordStar
Z3KAYDSK.MSG	Comments on Z-System for Kaypro
Z3TRBO12.LBR	Install ZCPR3 on Kaypro w/TurboROM
Z3TURKP2.LBR	ZCPR3 Install - Kaypro with TurboROM

    Library 37. Visual-1050 CP/M

BCOMP-VT.ARK	BCOMP for VISUAL 1050
BCOMP-VT.FIX	Fixes for BCOMP-VT.ARK
GDUMP.LBR	Graphic screen dump, Visual 1050
I2VI-2.AZM	IMP Overlay - Visual 1050
MXH-VI10.AZM	MEX Overlay - Visual 1050
TPIN1050.LBR	Visual-1050 installation routine
VLIB10.ARK	Visual 1050 Library Disk #10
VLIB11.ARK	Visual 1050 Library Disk #11
VLIB12.ARK	Visual 1050 Library Disk #12
VLIB14.ARK	Visual 1050 Library Disk #14
VLIB15.ARK	Visual 1050 Library Disk #15
VLIB16.ARK	Visual 1050 Library Disk #16
VLIB17.ARK	Visual 1050 Library Disk #17
VLIB18.ARK	Visual 1050 Library Disk #18
VLIB19.ARK	Visual 1050 Library Disk #19
VLIB1A.ARK	V-1050 Software Library Disk #1A
VLIB1B.ARK	Visual 1050 Library Disk #1B
VLIB2.ARK	Visual 1050 Library Disk #2
VLIB20.ARK	Visual 1050 Library Disk #20
VLIB21.ARK	Visual 1050 Library Disk #21
VLIB22.ARK	Visual 1050 Library File #22
VLIB23.ARK	Visual 1050 Library Disk #23
VLIB24.ARK	Visual 1050 Library Disk #24
VLIB25.ARK	Visual 1050 Library Disk #25
VLIB26.ARK	Visual 1050 Library Disk #26
VLIB27.ARK	Visual 1050 Library Disk #27
VLIB28.ARK	Visual 1050 Library Disk #28
VLIB29.ARK	Visual 1050 Library Disk #29
VLIB3.ARK	Visual 1050 Library Disk #3
VLIB30.ARK	Visual 1050 Library Disk #30
VLIB31.ARK	Visual 1050 Library Disk #31
VLIB32.ARK	Visual 1050 Library Disk #32
VLIB33.ARK	Visual 1050 Library Disk #33
VLIB34.ARK	Visual 1050 Library Disk #34
VLIB35.ARK	Visual 1050 Library Disk #35
VLIB36.ARK	Visual 1050 Library Disk #36
VLIB37.ARK	Visual 1050 Library Disk #37
VLIB39.ARK	Visual 1050 Library Disk #39
VLIB40.ARK	Visual 1050 Library Disk #40
VLIB41.ARK	Visual 1050 Library Disk #41
VLIB42.ARK	Visual 1050 Library Disk #42
VLIB43.ARK	Visual 1050 Library Disk #43
VLIB44.ARK	Visual 1050 Library Disk #44
VLIB45.ARK	Visual 1050 Library Disk #45
VLIB46.ARK	Visual 1050 Library Disk #46
VLIB47.ARK	Visual 1050 Library Disk #47
VLIB48.ARK	Visual 1050 Library Disk #48
VLIB5.ARK	Visual 1050 Library Disk #5
VLIB50.ARK	Visual 1050 Library Disk #50
VLIB52A.ARK	Visual 1050 Library Disk #52A
VLIB52B.ARK	Visual 1050 Library Disk #52B
VLIB53.ARK	Visual 1050 Library Disk #53
VLIB55.ARK	Visual 1050 Library Disk #55
VLIB56.ARK	Visual 1050 Library Disk #56
VLIB57.ARK	Visual 1050 Library Disk #57
VLIB59.ARK	Visual 1050 Library Disk #59
VLIB6.ARK	Visual 1050 Library Disk #6
VLIB60.ARK	Visual 1050 Library Disk #60
VLIB61.ARK	Visual 1050 Library Disk #61
VLIB62.ARK	Visual 1050 Library Disk #62
VLIB63.ARK	Visual 1050 Library Disk #63
VLIB64.ARK	Visual 1050 Library Disk #64
VLIB67.ARK	Visual 1050 Library Disk #67
VLIB68.ARK	Visual 1050 Library Disk #68
VLIB69.ARK	Visual 1050 Library Disk #69
VLIB7.ARK	Visual 1050 Library Disk #7
VLIB70.ARK	Visual 1050 Library Disk #70
VLIB71.ARK	Visual 1050 Library Disk #71
VLIB72.ARK	Visual 1050 Library Disk #72
VLIB73.ARK	Visual 1050 Library Disk #73
VLIB74.ARK	Visual 1050 Library Disk #74
VLIB77.ARK	Visual 1050 Library Disk #77
VLIB78.ARK	Visual 1050 Library Disk #78
VLIB79.ARK	Visual 1050 Library Disk #79
VLIB8.ARK	Visual 1050 Library Disk #8
VLIB9.ARK	Visual 1050 Library Disk #9
VTCFONT.ARK	Font generation for Visual-1050
VTCRESET.TXT	Make a reset switch, Visual 1050
VTCRLE.LBR	RLE graphics for the Visual 1050
VTGRAF2.ARK	Revisions for VTGRAFIC.ARK
VTGRAFIC.ARK	Visual-1050 specific graphics pgms.
VTSTATS.ARK	Simple Statistics
WS4VTC.LBR	WS4 function key patch, Visual 1050

    Library 38. Unclassified [Everything Else]

22DSK130.ARC	CP/M disk conversion for MS-DOS
22NCE124.ARC	CP/M 2.2 emulater for MS-DOS systems
ARCBOOT.EXE	IBM VM/SP library utility bootstrap
ARCUTIL.LBR	IBM VM/SP library utility
BIGCAL22.LBR	Produce wall sized calendar
BOXINBOX.ARK	Seasonal software adventure
CNKYOS22.LBR	BIOS for Columbia M64
CRC-C.ARC	Fast table-driven CRC in C-language
CRYP512.LBR	Secure encryption of data files
CRYPTANA.LBR	Cryptanalysis collection of tables
DEDPK87.ARK	WA8DED ver 1.2 PK-87 packet firmware
DEDTNC1.ARK	WA8DED ver 1.2 TNC-1 packet firmware
DEDTNC2.ARK	WA8DED ver 1.2 TNC-2 packet firmware
DZ80MU.DOC	Fix for DAZZLESTAR (DZ) under Z80MU
HAM10/T.ARK	Error correction using Hamming codes
HAMMODEM.LBR	Hams - Transfer CP/M files over VHF
HDOS3-0.ARK	Vol.1 HDOS 3.0 for Heath/Zenith 8/89
HDOS3-1.ARK	Vol.2 HDOS 3.0 for Heath/Zenith 8/89
HDOS3-2.ARK	Vol.3 HDOS 3.0 for Heath/Zenith 8/89
HGENSCSI.LBR	Ampro LB SCSI / Xebec 1410 autoboot
JETPRIME.LBR	Super-fast version of Byte's SIEVE
LPUT16B.LBR	Build libraries, add and replace
LZ.ARC		MS-DOS MASM source for LZW compress
LZHSRC10.ARC	C source for LHarc's LZHuff compress
MNPROP2.LBR	Radio H.F. propagation predictions
MORSETXT.LBR	Send text files with Morse Code
MU-DEMO.ARC	5.0 demo-CP/M & Z80 emulator (MSDOS)
NOSLTPOP.LBR	Displays clock while running program
RLI120.ARK	W0RLI MailBox/GateWay, version 12.0
RLI120.UPD	Update info W0RLI Packet BBS/Gateway
SENDCW03.LBR	Radio Amateurs send CW with Osborne
SPEC.LBR	Protect trial software
SQUASH.ARC	C-language squashed ARC compression
SWDEMO10.LBR	Windowing library subroutines
TEC2.LBR	Ham Radio Technician test aid
UNCR233.ARC	Uncrunch CP/M files on MS-DOS
V2080J88.ARC	CP/M emulator for MSDOS with NEC V20
VMSSWEEP.LBR	ARC/LBR/USQ/UNCR utility for VAX/VMS
X-10.LBR	X-10 wireless controller interface
X10V43.LBR	CP/M program to control BSR X10
Z80MU310.ARC	Z80 CP/M emulator for use on IBM PC
